values-cs/strings.xml:1605:	<string name="echo_cancellation">Zrušení echa</string>
values-da/strings.xml:1605:	<string name="echo_cancellation">Ekkoundertrykkelse</string>
values-it/strings.xml:1612:	<string name="echo_cancellation">Rimozione eco</string>
values-ar/strings.xml:1617:	<string name="echo_cancellation">إلغاء الصدى</string>
values-fr/strings.xml:1614:	<string name="echo_cancellation">Annulation d\'écho</string>
values-el/strings.xml:1611:	<string name="echo_cancellation">Ακύρωση αντήχησης</string>
values-nl/strings.xml:1605:	<string name="echo_cancellation">Echo-onderdrukking</string>
values-es/strings.xml:1612:	<string name="echo_cancellation">Cancelación de eco</string>
values-fi/strings.xml:1605:	<string name="echo_cancellation">Kaiunpoisto</string>
values-sv/strings.xml:1605:	<string name="echo_cancellation">Ekodämpning</string>
values-tr/strings.xml:1605:	<string name="echo_cancellation">Eko İptali</string>
values-pl/strings.xml:1612:	<string name="echo_cancellation">Eliminacja echa</string>
values-pt-rPT/strings.xml:1605:	<string name="echo_cancellation">Cancelamento do eco</string>
values-ca/strings.xml:1605:	<string name="echo_cancellation">Cancelación de eco</string>
values-hu/strings.xml:1607:	<string name="echo_cancellation">Visszhang-kiegyenlítés</string>
values-en-rGB/strings.xml:1595:	<string name="echo_cancellation">Echo Cancellation</string>
values-ko/strings.xml:1612:	<string name="echo_cancellation">에코 제거</string>
values-pt-rBR/strings.xml:23:    <string name="echo_cancellation">Cancelamento do eco</string>
values-zh-rTW/strings.xml:1616:	<string name="echo_cancellation">回音消除</string>
values-ru/strings.xml:1614:	<string name="echo_cancellation">Подавление эха</string>
values-sk/strings.xml:1605:	<string name="echo_cancellation">Potlačenie akustickej ozveny</string>
values-de/strings.xml:1614:	<string name="echo_cancellation">Echounterdrückung</string>
values-es-rUS/strings.xml:1605:	<string name="echo_cancellation">Cancelación de eco</string>
values-zh-rCN/strings.xml:1612:	<string name="echo_cancellation">回音消除</string>
values-ja/strings.xml:1614:	<string name="echo_cancellation">エコーキャンセラー</string>
values-nb/strings.xml:1605:	<string name="echo_cancellation">Ekkokompensering</string>
