a   	夺	*+
aa  	寸	*+
aaa 	鑫	*+
aadk	锒	 +
aado	枪	 +
aaf 	钱	*+
aaj 	铧	*+
aaja	镈	 +
aajq	铺	 +
aan 	锒	*+
aao 	铪	*+
aaoh	镎	*+
aaom	钥	*+
aap 	铃	*+
aaqi	钺	*+
aaqn	铖	*+
aaqq	钱	 +
aat 	铃	*+
aax 	钹	*+
aaxu	钹	 +
aaxx	钹	 +
aay 	钤	*+
aay 	铖	*+
ab  	镇	*+
ab  	锁	*+
aba 	佘	*+
aba 	钚	*+
abby	锉	*+
abd 	镨	*+
abe 	镫	*+
abed	镨	 +
abef	镒	*+
abew	镃	*+
abi 	郎	*+
abk 	铨	*+
abkd	镁	*+
abnp	锩	 +
abo 	铅	*+
abod	镨	 +
abor	锐	*+
abpd	锴	*+
abq 	畲	*+
abqp	锑	 +
abto	锕	*+
abv 	锁	*+
ac  	镜	*+
aca 	锊	*+
acdj	镡	 +
acew	录	 +
acf 	铌	*+
aci 	钟	*+
acj 	钟	*+
acjo	锯	*+
acl 	钯	*+
acm 	镅	*+
acn 	铎	*+
aco 	铭	*+
acr 	剑	*+
acrs	镖	*+
acs 	链	*+
acw 	链	*+
acyo	锔	*+
ad  	会	*+
ada 	会	 +
ada 	钛	*+
ada 	为	 +
ada 	锝	*+
adac	飙	*+
adax	飙	*+
adb 	锟	*+
adb 	郐	 +
adbs	镣	 +
adc 	铯	*+
adcl	铯	 +
add 	锠	*+
addq	镏	 +
ade 	钽	*+
adep	敛	 +
adfu	镘	 +
adg 	焊	*+
adj 	钭	*+
adjr	锛	*+
adk 	银	*+
adk 	良	 +
adkb	郎	 +
adku	朗	 +
adn 	犬	*+
adnm	锡	 +
ado 	仓	*+
ador	创	 +
adp 	铆	*+
adr 	刽	*+
adrw	刨	 +
adto	锜	 +
adua	锝	*+
adub	郎	 +
aduu	朗	 +
ae  	金	*+
ae  	佥	*+
ae  	亼	*+
ae  	钅	*+
aea 	锊	*+
aed 	铠	*+
aee 	钮	*+
aee 	铮	 +
aeem	镠	 +
aefe	铔	*+
aefl	铠	 +
aegu	锾	 +
aeh 	锈	*+
ael 	钝	*+
aem 	镠	*
aenm	钖	*+
aenu	锓	 +
aeot	镉	*+
aep 	锡	*+
aeru	锻	*+
aes 	佘	*+
aesq	畲	 +
aeuu	镚	*+
aew 	键	*+
aew 	录	 +
aex 	锾	*+
aez 	钲	*+
af  	点	*+
afa 	铸	*+
afb 	镤	*+
afc 	锣	*+
afdd	锲	*+
afe 	盛	*+
afed	镤	 +
afek	镮	*+
aff 	钜	*+
aff 	盏	 +
aff 	锬	*+
affd	铹	*+
afk 	钙	*+
afn 	钬	*+
afnc	镯	*+
afo 	钷	*+
afr 	刬	*+
afs 	铄	*+
afsv	锣	 +
afvd	镞	*+
afvz	镟	*+
afx 	戋	*+
afy 	铎	*+
afy 	钫	*+
afyg	铎	 +
ag  	威	*+
agca	锵	*+
age 	锤	*+
agea	锵	*+
agg 	锸	*+
agiu	锼	 +
agj 	钎	*+
agjy	锤	 +
agn 	铗	*+
ago 	钳	*+
ago 	铷	*+
ago 	铦	*+
agq 	锺	*+
agry	锤	 +
agu 	锼	*+
agua	锵	*+
agx 	钕	*+
agy 	镑	*+
ah  	感	*+
aha 	愈	*+
aha 	怼	 +
ahdd	锲	*+
ahf 	锹	*+
ahk 	表	 +
aho 	锗	*+
ahp 	铋	*+
ahr 	锈	*+
ahu 	锖	*+
ai  	俞	*+
aia 	镈	*
aigu	锼	 +
aij 	铺	*+
ain 	钦	*+
ain 	敛	 +
aiq 	铀	*+
aix 	锇	*+
aj  	华	*+
ajak	铁	 +
ajb 	镇	 +
ajd 	镫	*+
ajj 	针	*+
ajmb	镇	 +
ajn 	铈	*+
ajnp	敷	 +
ajnq	甫	 +
ajnw	逋	*+
ajo 	钴	*+
ajqs	链	 +
ajw 	求	 +
ajwk	裘	 +
ajwp	救	 +
ajww	逑	*+
ak  	驻	*+
aka 	钰	*+
ake 	主	*+
aki 	锨	*+
akj 	钘	*+
akk 	兮	*+
akl 	尤	*+
akm 	龙	*+
akmb	锧	*+
akp 	龙	*+
akpb	龚	 +
akpi	詟	*
akpk	袭	 +
akpo	砻	 +
akpr	聋	 +
akpy	垄	 +
akpy	垅	 +
akr 	铏	*+
akt 	钻	*+
aku 	铥	*+
akw 	铤	*+
akx 	钱	*+
al  	也	*+
al  	龙	*+
ala 	镣	*+
albf	镳	*+
albi	镢	*+
aldh	镱	*+
aldr	镜	 +
aleq	镛	*+
alho	镐	*+
alj 	锌	*+
alk 	袭	*+
alk 	铱	*+
alk 	锿	*+
all 	铲	*+
all 	钆	*+
aln 	镶	*+
aln 	铈	 +
aln 	铼	*+
alnf	镑	 +
alno	镐	*+
alno	镝	 +
alo 	砻	*+
alo 	锫	*+
alok	镶	 +
alok	锿	 +
aloo	镐	*+
alop	镦	*+
alp 	铲	*+
alpq	镰	 +
alps	铲	 +
alq 	镰	*+
alq 	钟	 +
alr 	钪	*+
alru	镀	*+
alu 	钣	*+
alv 	龙	*+
alw 	铉	*+
alww	镃	*
alx 	铰	*+
alzp	镦	*+
am  	贪	*+
amb 	钡	*+
ambr	铡	*+
amcs	镧	 +
amd 	锄	*+
amd 	锏	*+
amg 	镂	*+
ami 	钔	*+
amj 	仑	*+
amjs	镧	 +
amk 	锎	*+
aml 	毹	*+
amn 	镧	*+
amo 	钼	*+
amp 	钐	*+
amr 	觎	*+
amx 	镘	*+
amy 	钔	*+
an  	良	*+
an  	矣	*+
ana 	钓	*+
anb 	钧	*+
anb 	钠	*+
anbc	镩	*+
anbe	钢	 +
anbo	熔	 +
anbo	镕	 +
anbs	镩	*+
anc 	铯	*+
ancb	镔	*+
ancl	铯	 +
ane 	铮	*+
aneo	铜	*+
aneq	镓	*+
anez	锭	 +
anf 	铊	*+
ang 	铵	*+
anj 	镲	*+
anjs	镲	 +
ankb	镔	*+
anl 	刨	*+
anl 	铇	*
anmh	锪	*+
ano 	钩	*+
anoa	镵	*+
anol	刨	 +
anol	铇	 +
anpb	镔	*+
anr 	钧	*+
anrc	镩	*+
anrs	镩	*+
ansb	镔	*+
anu 	钩	*+
anw 	熔	*+
anw 	镕	*
anx 	钢	*+
anz 	锭	*+
ao  	后	*+
ao  	铝	*+
aoa 	龛	*+
aoaf	龛	 +
aoap	龛	 +
aob 	合	*+
aobp	敛	 +
aoc 	囱	*+
aod 	铟	*+
aoee	翕	*+
aoei	歙	*+
aof 	盒	*+
aoh 	拿	*+
aojo	锢	*+
aok 	锷	*+
aok 	锃	*+
aoll	龛	 +
aon 	铞	*+
aon 	镮	*
aonb	锅	 +
aonf	鸽	*+
aono	锔	*+
aoo 	合	*+
aoo 	铝	 +
aoo 	扣	*+
aoob	佥	 +
aooi	敛	 +
aook	锷	 +
aoom	龠	*+
aoop	敛	 +
aoor	剑	 +
aop 	命	*+
aopo	铝	 +
aoq 	镏	*+
aot 	颌	*+
aotb	颌	 +
aov 	铝	*+
ap  	救	*+
apa 	钋	*+
apb 	邻	*+
apd 	铂	*+
apdk	锽	*+
apdn	锦	 +
ape 	铚	*+
apee	翎	*+
apf 	锋	*+
apfj	铧	 +
api 	令	*+
apj 	锦	*+
apl 	锩	*+
apmt	镍	*+
apnf	鸰	*
apo 	铬	*+
apt 	领	 +
apt 	镍	*+
aptb	领	 +
apu 	钑	*+
apw 	瓴	*+
apx 	敛	*+
apx 	铍	*+
aq  	贫	*+
aqaf	盏	 +
aqb 	戍	*+
aqd 	会	 +
aqdb	郐	 +
aqdr	刽	 +
aqe 	锂	*+
aqer	铙	 +
aqfs	戚	 +
aqgr	臧	*+
aqh 	锶	*+
aqi 	钾	*+
aqj 	戎	*+
aqn 	成	 +
aqnf	盛	 +
aqo 	锅	*+
aqo 	镐	*+
aqo 	钿	*+
aqoc	镪	*+
aqoe	或	 +
aqoh	惑	 +
aqp 	戊	*+
aqpa	戍	 +
aqpe	戌	 +
aqpf	盛	 +
aqpg	威	 +
aqph	感	 +
aqph	戚	 +
aqpo	咸	 +
aqps	戚	 +
aqpy	成	 +
aqpz	蹙	*+
aqr 	戒	*+
aqr 	划	 +
aqs 	镙	*+
aqt 	锞	*+
aquc	镪	*+
aqv 	戌	*+
aqvg	威	 +
aqvh	感	 +
aqvo	咸	 +
aqx 	戈	*+
aqx 	戎	 +
ar  	划	*+
ar  	戒	*+
ara 	钒	*+
ara 	铫	*+
arb 	龚	*+
arbb	铫	*+
arc 	锳	*+
ard 	错	*+
ardd	镆	*+
arf 	监	*+
arf 	铓	*+
ari 	剑	*+
ari 	钊	*+
arj 	聋	*+
arj 	铒	*+
arjq	铧	 +
ark 	铐	*+
arn 	铄	*+
arn 	钑
arnd	铹	*+
aro 	铅	*+
aro 	锘	*+
arq 	锚	*+
arrj	铧	 +
arrr	镊	*+
aruu	镊	*+
aruy	铿	*+
arv 	戒	*+
arvf	监	 +
arvu	镬	*+
arww	镃	*
arx 	锓	*+
arxo	锘	*+
as  	戚	*+
asb 	铢	*+
ase 	铛	*+
ase 	佥	 +
asei	敛	 +
asep	敛	 +
aser	剑	 +
asfs	镴
asi 	钏	*+
asj 	书	*+
asl 	镴	*+
asmb	锁	 +
asn 	铁	*+
asnd	铹	*+
asnq	铛	 +
asnr	镋	*+
asny	镗	*+
aso 	铛	*+
aso 	锆	*+
asos	镴
asp 	钞	*+
asq 	锱	*+
asr 	铣	*+
asrb	钻	 +
ass 	铢	*+
asu 	销	*+
at  	领	*+
ata 	令	*+
atb 	邻	*+
atd 	斜	*+
ate 	钵	*+
atee	翎	*+
atek	衾	 +
ati 	钉	*+
atk 	衾	*+
atl 	术	*+
atl 	铳	*+
atn 	术	*+
atn 	余	 +
atn 	馀	 +
atnf	鸰	*+
ato 	钶	*+
atp 	锑	*+
atp 	叙	 +
atr 	刽	*+
atr 	铳	*+
ats 	锍	*+
att 	领	 +
attb	领	 +
atu 	叙	*+
atw 	述	*+
atw 	途	 +
atw 	瓴	 +
atzu	叙	 +
au  	奧	*+
au  	澳	*+
aua 	钗	*+
aua 	锊	 +
aue 	朗	*+
aue 	钥	*+
aue 	铕	 +
aued	镥	*+
aufd	镥	*+
auq 	镭	*+
auq 	铎	 +
aur 	俞	 +
aurh	愈	 +
aurm	毹	 +
aurr	觎	 +
aurw	逾	 +
auv 	澳	*+
av  	今	*+
ave 	锥	*+
avm 	镌	*+
avm 	钖	*
avmb	镄	*+
avn 	镤	*+
avo 	锜	*
avr 	镌	*+
avu 	镌	*+
av, 	ぁ	*+
av. 	ァ	*+
aw  	逾	*+
awdm	铴	 +
awe 	铴	*+
awf 	钨	*+
awi 	钌	*+
awj 	书	*+
awl 	铲	*+
awls	铲	 +
awm 	锡	*+
awm 	钖	*
awn 	过	*+
awn 	逾	 +
awn 	逅	 +
awn 	冰	 +
awo 	铻	*+
awpt	铄	 +
awwm	铴	 +
ax  	贷	*+
axb 	铘	*+
axe 	铕	*+
axe 	壹	 +
axf 	龙	*+
axfb	龚	 +
axfi	詟	*+
axfk	袭	 +
axfo	砻	 +
axfr	聋	 +
axfy	垄	 +
axfy	垅	 +
axg 	甙	*+
axh 	忒	*+
axi 	式	*+
axj 	镡	*+
axn 	钸	*+
axnf	鸢	*+
axo 	镝	*+
axr 	贰	*+
axrb	贰	 +
axt 	铩	*+
axu 	发	 +
axu 	铕	 +
axx 	义	 +
axx 	弋	*+
ay  	成	*+
ayb 	铘	*+
ayd 	锗	*+
aye 	垄	*+
aye 	镒	*+
aye 	钍	*+
ayh 	念	*+
aylk	衾	 +
aymb	贪	 +
ayo 	含	*+
ayob	颔	*+
ayoq	铁	 +
ayot	颔	*+
aypd	锗	 +
aypf	铑	*+
aypk	铐	 +
ayr 	铙	*+
ayy 	今	 +
ayya	铸	 +
ayym	钖	*
ayyr	铙	 +
az  	之	*+
azf 	锰	*+
azl 	钇	*+
azn 	之	 +
azo 	钻	*+
azqf	炉	 +
azz 	钇	*+
a,  	あ	*+
a,  	ぁ	*+
a.  	ア	*+
a.  	ァ	*+
b   	八	*+
ba  	不	*+
ba  	丷	*+
baa 	亽	*+
bac 	险	*+
bae 	险	*+
bafu	阴	 +
bajq	铺	 +
bakp	陇	 +
bal 	陇	*+
baob	险	 +
bap 	冷	*+
baqo	减	 +
base	险	 +
bat 	冷	*+
bat 	除	 +
baxf	陇	 +
bayt	阴	 +
bayu	阴	 +
ba, 	ば	*+
ba. 	バ	*+
bb  	资	*+
bba 	仒	*+
bbb 	众	*+
bbbf	鹡	*+
bbbj	伞	 +
bbbu	脊	 +
bbe 	丛	*+
bbef	隘	*+
bbeq	队	 +
bbeu	阴	 +
bbew	隧	*+
bbey	坠	 +
bbh 	除	*+
bbh 	怂	*+
bbh 	涂	 +
bbi 	邓	*+
bbj 	伞	*+
bbm 	俎	*+
bbn 	从	*+
bbn 	队	 +
bbo 	谷	 +
bbof	鹆	*+
bboh	欲	 +
bboi	欲	 +
bbop	却	 +
bbpd	阶	 +
bbq 	芈	*+
bbr 	阶	*+
bbr 	耸	*+
bbv 	队	 +
bby 	坐	*+
bby 	坠	 +
bby 	陛	*+
bc  	爸	*+
bc  	冻	*+
bci 	冲	*+
bcj 	阵	*+
bcj 	冲	 +
bcs 	陈	*+
bcs 	冻	 +
bct 	柒	*+
bd  	普	*+
bd  	剪	*+
bda 	头	*+
bde 	岔	*+
bde 	冱	 +
bdem	阳	 +
bdez	堤	 +
bdf 	毙	*+
bdf 	盆	 +
bdh 	忿	*+
bdk 	限	*+
bdmb	贫	 +
bdn 	头	*+
bdo 	阳	*+
bdo 	普	 +
bdp 	分	*+
bdp 	剪	 +
bdr 	冽	*+
bdt 	颁	*+
bdtb	颁	 +
bdv 	剪	*+
bdwf	隰	*+
bdy 	坌	*+
bdy 	陧	*+
be  	登	*+
be  	翁	*+
bea 	尊	*+
bead	猷	*+
beap	夔	*+
beaw	遵	 +
beb 	邳	*+
bebc	蠲	*+
bebf	益	 +
bebf	鹢	 +
becf	毙	 +
bed 	奠	*+
bed 	关	 +
bedb	郑	 +
bedw	送	 +
bee 	丕	*+
bee 	翦	*+
beef	兼	 +
beeh	隐	 +
beei	歉	 +
befd	普	 +
befe	并	 +
beih	隐	 +
bel 	陋	*+
benl	陋	 +
beo 	酋	*+
beot	隔	 +
bep 	阳	*+
beqw	遂	*+
ber 	阢	*+
berf	鹣	 +
besi	陉	 +
beu 	朔	*+
beud	剪	 +
beue	翦	*+
beuf	煎	 +
beur	前	 +
beut	槊	*+
beuy	塑	 +
bev 	翁	*+
bew 	逆	*+
bew 	遒	*+
bewf	鹚	*+
bewh	慈	 +
beww	兹	 +
bewz	孳	*+
bez 	歪	*+
bezp	夔	*+
be, 	べ	*+
be. 	ベ	*+
bf  	益	*+
bf  	盆	*+
bfa 	煎	*+
bfe 	杯	*+
bfg 	狭	*+
bfl 	仑	*+
bfn 	凑	*+
bfnd	凑	 +
bfnn	凑	 +
bft 	柒	*+
bfu 	脊	*+
bfuf	鹡	*
bfv 	盆	*+
bfvz	凝	 +
bfy 	防	*+
bg  	障	*+
bge 	陲	*+
bgg 	并	*+
bgj 	阡	*+
bgjy	陲	 +
bgn 	陕	*+
bgn 	关	 +
bgnb	郑	 +
bgnw	送	 +
bgo 	舍	*+
bgob	馆	 +
bgoi	铺	 +
bgoq	铺	 +
bgou	舒	 +
bgry	陲	 +
bgz 	孬	*+
bh  	隐	*+
bh  	慈	*+
bha 	憋	*+
bha 	余	 +
bhap	羚	*+
bhat	羚	*+
bhbb	鄯	*+
bhbo	善	 +
bhd 	斜	*+
bhd 	羯	*+
bhdl	羯	*+
bhe 	羞	*+
bhee	翔	*+
bhef	羰	*+
bhei	羟	*+
bhh 	羧	*+
bhi 	差	 +
bhj 	羊	*+
bhle	膻	*+
bhlm	膻	*+
bhm 	着	 +
bhn 	余	*+
bhn 	馀	 +
bhna	养	 +
bhnk	养	 +
bhnr	养	 +
bhp 	叙	*+
bhp 	毖	*+
bhq 	畲	*+
bhrb	鄯	*+
bhro	善	 +
bhsi	羟	*+
bhu 	叙	*+
bhuf	鲝	*
bhui	羟	*+
bhup	羧	 +
bhuy	羟	*+
bhv 	慈	*+
bhw 	途	*+
bhxa	羝	*+
bhxe	羝	*+
bhzu	叙	 +
bi  	前	*+
bi  	丫	*+
bicc	螀	*
bie 	仝	*+
bif 	盗	*+
big 	姿	*+
bih 	恣	*+
bii 	个	 +
bii 	丫	 +
bij 	铺	*+
bim 	粢	*+
bimb	资	 +
bin 	次	*+
bio 	咨	*+
biuc	螀	*
biv 	丫	*+
biw 	瓷	*+
bi, 	び	*+
bi. 	ビ	*+
bj  	半	*+
bj  	阱	*+
bja 	际	 +
bjeg	凄	 +
bjg 	凄	*+
bjj 	毕	*+
bjj 	阱	 +
bjj 	仐	*+
bjn 	决	*+
bjn 	堤	 +
bjqs	陈	 +
bjqs	冻	 +
bjrs	际	 +
bjv 	阱	*+
bk  	全	*+
bkbb	鄯	*+
bkbi	羡	*+
bkbo	善	 +
bkbr	养	 +
bkd 	美	*+
bke 	全	 +
bkf 	盖	*+
bkf 	羔	*+
bkfd	羹	*+
bkg 	姜	*+
bkh 	恙	*+
bki 	义	 +
bkik	羲	 +
bkir	羲	 +
bkj 	并	*+
bkk 	兮	*+
bkk 	羲	 +
bko 	减	*+
bkpe	羞	 +
bkpf	鲝	*+
bkpi	差	 +
bkpm	着	 +
bkr 	羌	*+
bkrb	鄯	*+
bkro	善	 +
bkw 	瓶	*+
bkw 	迸	*+
bkwi	羡	*+
bkx 	养	 +
bl  	比	*+
bl  	陋	*+
bla 	禽	*+
bldj	障	 +
blh 	陔	*+
bll 	亡	 +
blo 	陪	*+
bloh	凛	*+
blos	凉	 +
blos	凛	 +
bls 	凉	*+
blu 	叛	*+
blu 	阪	 +
blul	陇	 +
blv 	陋	*+
blxu	禽	 +
bm  	着	*+
bmc 	邻	*+
bmcs	邻	 +
bme 	阻	*+
bmf 	冯	*+
bmfh	凭	 +
bmn 	籴	*+
bmo 	瞥	*+
bn  	人	*+
bn  	乀	*+
bnb 	馆	*+
bnd 	券	*+
bne 	净	*+
bneh	隐	 +
bneq	豢	*+
bnf 	陀	*+
bng 	陷	*+
bnh 	拳	*+
bni 	陶	*+
bni 	誊	*+
bnj 	币	*+
bnm 	眷	*+
bno 	凋	*+
bnp 	卷	 +
bnq 	甭	*+
bnrr	院	 +
bnt 	桊	*+
bnuf	鲞	*+
bnwu	陶	 +
bnyo	凋	 +
bo  	曾	*+
bo  	舍	*+
boa 	险	*+
bod 	普	 +
boe 	并	*+
boh 	总	*+
bomb	陨	*+
boo 	否	*+
bor 	况	*+
bor 	兑	 +
boz 	蹩	*+
bo, 	ぼ	*+
bo. 	ボ	*+
bp  	入	*+
bp  	陵	*+
bp  	丷	*
bpa 	附	*+
bpaq	戗	*+
bpd 	皆	*+
bpdk	隍	*+
bpes	隆	 +
bpg 	陴	*+
bpi 	兯	*+
bpl 	仓	*+
bpnf	鸧	*+
bpqg	陴	 +
bpqu	隗	 +
bpr 	创	*+
bps 	降	*+
bps 	隆	 +
bpv 	陵	*+
bpx 	陂	*+
bq  	队	*+
bqd 	曾	 +
bqdw	甑	 +
bqe 	陆	*+
bqeo	兽	*+
bqif	鹈	*+
bqip	弟	 +
bqir	剃	 +
bqiw	递	*+
bqj 	单	 +
bqjb	郸	*+
bqjk	冁	*+
bqjq	战	 +
bqk 	别	*+
bqk 	隈	*+
bqnu	隅	*+
bqp 	弟	 +
bqpf	鹈	*+
bqpr	剃	 +
bqpw	递	*+
bqu 	陆	*+
bqy 	别	*+
br  	介	*+
br  	兑	 +
bri 	判	*+
bri 	介	 +
brj 	弊	*+
brl 	凳	*+
brp 	羲	*+
brr 	阮	*+
brrf	鹡	*
brru	脊	 +
brs 	际	 +
brs 	佘	 +
brsq	畲	 +
bru 	陬	*+
brv 	兑	 +
brz 	凳	*+
bs  	际	*+
bs  	隆	*+
bsds	隙	*+
bse 	兰	*+
bsi 	陉	*+
bsps	隙	*+
bsr 	冼	*+
bsv 	隆	*+
bt  	隔	*+
bta 	会	 +
btb 	郐	*+
btbu	凇	*+
btd 	陌	*+
btm 	首	 +
btma	导	 +
btme	馘	 +
btmh	馘	 +
btmp	夔	*+
btmw	道	 +
btnl	陋	 +
bto 	阿	*+
btr 	刽	*+
btzp	夔	*+
bu  	版	*+
bu  	阪	*+
bua 	公	*+
bue 	阴	*+
buee	翁	 +
buef	鹟	*+
buf 	鳖	*+
bui 	舒	*+
bui 	陉	 +
buo 	冶	*+
but 	颂	*+
butb	颂	 +
buv 	阪	*+
buw 	瓮	*+
buy 	陉	*+
bu, 	ぶ	*+
bu. 	ブ	*+
bv  	善	*+
bva 	隗	*+
bve 	准	*+
bvf 	阼	*+
bvj 	准	*+
bw  	遵	*+
bw  	冰	*+
bwa 	甑	*+
bwf 	为	 +
bwn 	还	*+
bwn 	冰	 +
bwn 	氽	*+
bwn 	汆	*+
bwuu	禽	 +
bwv 	冰	*+
bx  	义	*+
bx  	敝	*+
bxa 	釜	*+
bxc 	爸	 +
bxcc	爹	*+
bxcl	爸	 +
bxge	釜	 +
bxiu	隋	*+
bxiw	随	 +
bxiy	堕	 +
bxk 	斧	*+
bxn 	随	 +
bxp 	爷	*+
bxrb	爷	 +
bxuf	隳	*+
bxuh	隳	*+
bxuw	随	 +
bxuy	堕	 +
bxv 	敝	*+
bxw 	随	 +
bxx 	父	*+
bxy 	堕	*+
bxy 	升	 +
by  	坠	*+
by  	陵	*+
bybp	凌	 +
bybp	陵	 +
byby	陆	 +
bye 	陆	*+
bye 	隘	*+
byo 	舍	*+
byrp	凌	 +
byrp	陵	 +
byry	陆	 +
byv 	陵	*+
byx 	凌	*+
byx 	陵	 +
byz 	陡	*+
bz  	凝	*+
bze 	企	*+
bzn 	乏	*+
bzo 	阽	*+
bzs 	陟	*+
bzsf	骘	*+
c   	七	*+
ca  	夕	*+
ca  	虫	*+
caa 	尉	*+
cab 	螂	*+
cadb	螂	 +
caf 	熨	*+
cah 	慰	 +
cai 	输	*+
cai 	蝓	*+
cajq	辅	 +
cak 	蛀	*+
cam 	轮	 +
cao 	蛤	*+
cap 	蛉	*+
caqe	蜮	 +
cat 	蛉	*+
cat 	蜍	 +
caur	输	 +
caur	蝓	 +
cav 	虫	*+
cax 	蚁	*+
caxi	轼	 +
cb  	舆	*+
cbe 	蝤	*+
cbf 	轮	 +
cbh 	蜍	*+
cbh 	蛘	*+
cbhh	羼	*+
cbho	蟮	*+
cbk 	屏	*+
cbk 	辁	*+
cbki	蚁	 +
cbko	蟮	*+
cbkr	蜣	*+
cbl 	屁	*+
cbl 	蚍	*+
cbm 	轸	*+
cbmx	餮	*+
cbnl	蜷	 +
cbnp	蜷	 +
cbo 	层	*+
cbor	蜕	*+
cbqd	层	 +
cbqj	蝉	 +
cbr 	蚧	*+
cbto	屙	*+
cbu 	蚣	*+
cbx 	蚁	*+
cc  	多	*+
cca 	多	 +
ccc 	虫	*+
ccc 	轰	 +
cccf	蛊	*+
cch 	患	*+
cch 	蟪	*+
cci 	串	*+
ccj 	串	*+
ccno	够	 +
ccrk	辗	*+
ccrs	螵	*+
ccua	转	 +
ccuh	蟪	*+
ccv 	飘	*+
cd  	屠	*+
cda 	轫	*+
cdb 	辊	*+
cdcr	挽	 +
cdf 	尸	 +
cdf 	辒	*+
cdi 	蝎	*+
cdj 	蚪	*+
cdj 	覃	 +
cdl 	蝎	*+
cdn 	轪	*+
cdni	蝎	 +
cdnl	蝎	 +
cdnm	蜴	 +
cdo 	轺	*+
cdow	迁	 +
cdp 	切	*+
cdpw	迁	 +
cdv 	蟆	*+
cdyy	蝰	*+
ce  	溪	*+
ceb 	辆	*+
cebw	遣	 +
cedo	轿	 +
cee 	屈	*+
ceff	彘	*+
cel 	挽	*+
cemb	贵	 +
cemr	彝	*+
cemw	遗	 +
cenb	辆	 +
cent	汇	 +
ceoq	辐	*+
ceoq	蝠	 +
cep 	蜴	*+
ceq 	彖	*+
ceqc	蠡	*+
cesi	轻	 +
cesi	蛏	 +
ceu 	屈	*+
cev 	昼	*+
cevf	彘	*+
cewr	剥	 +
ceww	逯	*+
cez 	蜉	*+
cf  	轮	*+
cfa 	虾	*+
cfe 	盎	*+
cfe 	盅	*+
cfe 	蛊	*+
cfft	蝾	*+
cfj 	蚌	*+
cfj 	蝣	*+
cfl 	尼	*+
cfl 	虻	*+
cfm 	蝙	*+
cfn 	辏	*+
cfn 	蛎	 +
cfnd	辏	 +
cfnd	蝽	*+
cfnh	螓	*+
cfnn	辏	 +
cfo 	蛐	*+
cfs 	轹	*+
cfu 	蝴	*+
cfvz	蝣	*+
cg  	履	*+
cgeb	舆	 +
cgi 	轿	*+
cgiu	螋	 +
cgj 	轩	*+
cgn 	蛱	*+
cgno	轿	 +
cgnr	轿	 +
cgo 	轿	*+
cgo 	蚶	*+
cgo 	蛞	*+
cgu 	螋	*+
cgx 	要	 +
cgy 	螃	*+
ch  	慰	*+
cha 	忠	*+
cha 	惠	 +
chd 	蝌	*+
che 	蜮	*+
chi,	ち	*+
chi.	チ	*+
chj 	轷	*+
cho 	屠	 +
chr 	蜊	*+
chu 	蜻	*+
ci  	中	*+
cie 	虹	*+
cigu	螋	 +
cij 	辅	*+
cin 	软	*+
ciq 	届	*+
ciq 	轴	 +
ciq 	蚰	*+
civ 	轼	*+
cix 	蛾	*+
ci, 	し	*+
ci. 	シ	*+
cj  	车	*+
cj  	中	 +
cj  	舛	*+
cjnf	鸨	*+
cjng	蝻	 +
cjo 	居	*+
cjo 	蛄	*+
cjo 	轱	*+
cjor	剧	 +
cjou	蝴	 +
cjqa	转	 +
cjqh	蟪	*+
cjqs	转	 +
ck  	展	*+
cka 	錾	*+
cka 	蟥	*+
ckb 	蜞	*+
ckd 	暂	*+
cke 	蚯	*+
cki 	斩	*+
ckl 	轨	*+
ckl 	尻	*+
ckt 	椠	*+
ckw 	蜓	*+
ckx 	轨	*+
ckx 	尻	*+
cky 	堑	*+
ckz 	轨	*+
ckz 	尻	*+
cl  	巴	*+
cl  	乜	*+
cla 	螭	*+
clb 	辘	*+
clbf	蠊	 +
clbj	蟀	 +
cldj	蟑	*+
cleo	螗	*+
clhq	蚝	*+
clj 	蟀	*+
cll 	轧	*+
cll 	虬	*+
clnf	螃	 +
clnq	蚝	*+
cloq	蚝	*+
clos	辌	 +
clp 	轭	*+
clps	螈	 +
clq 	蠊	*+
clru	蛎	 +
cls 	辌	*
clv 	蛎	*+
clwj	蟀	 +
clx 	较	*+
clx 	蛟	*+
clxu	螭	 +
cm  	薄	*+
cmb 	贾	*+
cmb 	屃	*
cmc 	辚	*+
cmcs	辚	 +
cme 	蛆	*+
cmf 	蚂	*+
cmg 	屡	*+
cmg 	蝼	*+
cmh 	蟋	*+
cmig	屦	*+
cmip	覆	 +
cmip	履	 +
cmis	屉	 +
cmiu	屐	*+
cmiv	履	 +
cmiv	覆	 +
cmiz	屣	*+
cml 	尾	*+
cml 	蚝	*+
cmmu	蠼	*+
cmn 	屎	*+
cmn 	粟	 +
cmnf	鹛	*+
cmo 	眉	*+
cmq 	蟠	*+
cmr 	蚬	*+
cmv 	粟	*+
cn  	央	*+
cna 	夤	*+
cnb 	尽	*+
cnb 	蚋	*+
cnb 	屃	*+
cnbf	辋	*+
cnbi	蟾	 +
cncp	蜿	*+
cncq	蟓	*+
cncr	挽	 +
cnde	昼	 +
cndl	螟	*+
cneb	夤	 +
cnf 	蛇	*+
cnf 	鸯	*+
cnf 	鸤	*+
cnfo	辖	*+
cnho	辖	*+
cnj 	蝻	*+
cnli	蟾	 +
cnn 	尺	*+
cnn 	蟓	*+
cno 	蜩	*+
cnob	咫	*+
cnqt	汇	 +
cnr 	刷	*+
cnw 	迟	*+
cny 	蚺	*+
cnyo	蜩	 +
co  	西	*+
co  	覀	*+
coae	蝈	 +
cob 	轵	*+
cobf	辒	*
coed	蜈	*+
cofu	虾	 +
cogn	蜈	*+
coh 	蝈	*+
coil	蝇	 +
coj 	蝉	*+
coka	蝈	 +
cokb	蜈	*+
cokd	蜈	*+
col 	辟	*+
cola	璧	 +
cola	鐾	 +
cold	劈	 +
colg	嬖	 +
colh	擘	 +
coli	譬	 +
colk	襞	*+
colt	檗	*+
colu	臂	 +
colw	避	 +
colw	甓	 +
coly	壁	 +
conb	蜗	 +
coo 	名	*+
coo 	蛔	*+
coo 	軎	*+
cooj	蝉	 +
coql	蝇	 +
cor 	辑	*+
cov 	雒	*+
cox 	虾	*+
cp  	尸	*+
cpa 	外	*+
cpbn	蛳	*+
cpcu	属	 +
cpdk	蝗	*+
cpdo	轿	 +
cpdr	轿	 +
cpdt	轹	 +
cpe 	屋	*+
cpe 	蛭	*+
cpe 	轾	*+
cpf 	蜂	*+
cpg 	蜱	*+
cph 	怨	*+
cph 	螅	*+
cpl 	蜷	*+
cpm 	眢	*+
cpmh	螅	*+
cpnf	鸳	*+
cpo 	蚯	*+
cpo 	辂	*+
cpqg	蜱	 +
cpv 	履	 +
cpzw	蜒	*+
cq  	轴	*+
cqa 	转	*+
cqer	蛲	 +
cqi 	蚓	*+
cqn 	蚨	*+
cqo 	蜗	*+
cqs 	螺	*+
cqt 	蜾	*+
cqv 	蝠	*+
cr  	剧	*+
crar	蟒	*+
crbu	殿	 +
crbu	臀	*+
crcu	霸	 +
crd 	蜡	*+
crdd	蟆	 +
crdr	蟒	*+
creb	螨	*+
creh	蟏	*+
cren	蛳	*+
crer	蟏	*
cres	蟏	*
crfa	蠛	*+
crfb	蠛	*+
crfd	螬	*+
crfv	蠛	*+
crk 	展	 +
crl 	辄	*+
crl 	虮	 +
crn 	轹	*+
crnb	螨	*+
crnq	蠓	*+
crnt	蝾	*+
crod	螬	*+
cror	蛐	 +
crqb	蟥	*+
crs 	票	*+
crsa	尉	 +
crsc	飘	 +
crsf	熨	 +
crsg	瓢	*+
crsh	慰	 +
crsr	剽	*+
crss	扉	*+
crsx	飘	 +
cruh	击	 +
crus	系	 +
cruy	墼	*+
crvu	蠖	*+
crz 	虮	*+
cs  	东	*+
csa 	东	 +
csb 	蛛	*+
csfs	腊	 +
csi 	轻	*+
csj 	舛	*+
csl 	屉	*+
csl 	腊	 +
csl 	蜡	 +
csn 	东	 +
csn 	柬	 +
csn 	轶	*+
csn 	蜡	 +
csnf	鸫	*+
csnt	蝾	*+
csny	螳	*+
csos	腊	 +
csos	蜡	 +
csq 	辎	*+
css 	蛛	*+
csso	辔	*+
cst 	蝶	*+
cst 	桀	*+
csu 	屑	*+
csu 	蛸	*+
ct  	市	*+
cta 	层	*+
ctj 	蛹	*+
ctk 	蜥	*+
ctn 	栗	*+
ctn 	桀	*+
ctnb	辆	 +
ctnq	蛹	 +
cto 	蚵	*+
cto 	轲	*+
ctup	辙	 +
ctx 	辙	*+
cu  	属	*+
cu  	殿	*+
cua 	专	 +
cuh 	惠	 +
cui 	轻	*+
cui 	蛏	*+
cur 	蠕	*+
curh	击	 +
curs	系	 +
cury	墼	*+
cus 	蛑	*+
cutr	蠕	 +
cuu 	轰	*+
cuuu	辍	*+
cuv 	殿	*+
cuy 	轻	*+
cuy 	蛏	*+
cv  	覆	*+
cv  	履	 +
cvdo	蜘	*+
cvdp	蝮	 +
cvf 	蚱	*+
cvo 	蟾	*+
cvv 	履	 +
cvx 	蝮	*+
cvz 	虼	*+
cw  	遣	*+
cw  	遗	*+
cwd 	蚴	*+
cwfc	属	 +
cwh 	蛴	*+
cwm 	蜴	*+
cwn 	连	*+
cwn 	尿	*+
cwn 	乃	 +
cwpt	轹	 +
cwr 	蛴	*+
cws 	犀	*+
cwsw	迟	 +
cwuu	螭	 +
cwv 	遗	*+
cwx 	蚊	*+
cx  	史	*+
cxa 	转	*+
cxl 	蝇	*+
cxn 	飧	*+
cxp 	蚜	*+
cy  	壁	*+
cya 	螈	*+
cyb 	鄄	*+
cyd 	屠	 +
cydm	蟛	*+
cyen	蛳	*+
cyo 	局	*+
cyok	辕	*+
cyom	蟛	*+
cyp 	蚜	*+
cypd	屠	 +
cyr 	蛲	*+
cyu 	届	*+
cyw 	甄	*+
cyy 	蛙	*+
cyyr	蛲	 +
cz  	债	*+
cza 	辀	*+
czc 	轳	*+
czf 	蜢	*+
czzz	孱	*+
c.  	！	*+
d   	的	*+
da  	歹	*+
da  	夺	 +
daa 	太	*+
daa 	夺	 +
daa 	时	 +
daa 	刃	 +
daav	夺	 +
daav	刃	 +
daav	时	 +
dac 	殓	*+
dadp	卿	 +
dae 	殓	*+
dae 	亘	*+
dae 	丒	*+
dah 	态	*+
dah 	忍	 +
daj 	晔	*+
dajq	晡	 +
dakp	昽	*
daob	殓	 +
dapa	卵	*+
dapz	孵	*+
daqn	晟	 +
daqq	残	 +
dase	殓	 +
dav 	忍	 +
daw 	边	 +
dax 	刃	*+
daxf	昽	*+
day 	晟	*+
dayo	晗	*+
da, 	だ	*+
da. 	ダ	*+
db  	贸	*+
dba 	办	*+
dba 	冭	 +
dbbe	歼	 +
dbdf	鹩	*+
dbdw	辽	 +
dbe 	冭	*
dbki	曦	*+
dbkk	曦	*+
dbkr	曦	*+
dbl 	昆	*+
dbm 	殄	*+
dbmx	餮	*+
dbnf	鹍	*+
dbqj	殚	 +
dbv 	殡	*+
dc  	贺	*+
dc  	殃	*+
dcf 	昵	*+
dcl 	色	*+
dcn 	映	*+
dcn 	殃	 +
dco 	晒	*+
dcr 	免	*+
dcra	兔	*+
dcrd	勉	 +
dcrw	逸	 +
dcv 	殃	*+
dd  	得	*+
dda 	斗	 +
ddar	刘	 +
ddbs	了	 +
ddcr	晚	 +
ddcr	冕	 +
ddd 	晶	*+
dddh	勰	*+
dddu	胁	 +
dde 	暨	*+
ddem	阳	 +
ddmb	贸	 +
ddo 	昌	*+
ddo 	昭	*+
ddof	照	 +
ddp 	昴	*+
ddq 	留	*+
ddqf	鹠	*+
ddqw	遛	 +
ddrw	曝	*+
ddup	卿	 +
ddv 	奢	*+
ddx 	夯	*+
ddy 	夯	*+
de  	豆	*+
de  	旦	*+
ded 	昊	*+
dee 	互	*+
dee 	旦	 +
deev	旦	 +
deev	曜	 +
deew	遢	*+
degu	暖	 +
del 	晚	 +
del 	冕	 +
denm	旸	 +
denp	暧	 +
denu	暧	 +
deol	鼌	*+
dep 	阳	*+
deq 	量	 +
deru	最	 +
deu 	套	*+
dev 	旦	*+
dex 	暖	*+
dez 	是	 +
dez 	殍	*+
dezb	题	 +
dezf	匙	 +
dezs	韪	*+
dezt	题	 +
dezw	韪	*+
de, 	で	*+
de. 	デ	*+
df  	照	*+
df  	驾	 +
dfe 	显	*+
dfeb	显	 +
dfet	显	 +
dfh 	曙	*+
dfk 	晨	*+
dfl 	死	*+
dfn 	炅	*+
dfoo	奁	 +
dfp 	昂	*+
dfro	昵	 +
dfu 	曼	 +
dfv 	驾	 +
dfx 	奁	*+
dfyd	曙	 +
dg  	歼	*+
dgff	焰	 +
dgi 	卿	*+
dgj 	旱	*+
dgj 	歼	 +
dgj 	旰	*+
dgn 	昊	*+
dgqf	曛	*+
dh  	忍	*+
dho 	暑	*+
dho 	奢	 +
dhu 	晴	*+
dhx 	暧	*+
di  	待	*+
die 	豇	*+
dij 	晡	*+
din 	歇	*+
dip 	昂	*+
diqf	鹌	*+
diql	奄	 +
di, 	ぢ	*+
di. 	ヂ	*+
dj  	斗	*+
dje 	殖	*+
djed	暌	*+
djgn	暌	*+
djj 	早	*+
djl 	殖	*+
djme	殖	 +
djml	殖	 +
djn 	闹	*+
djpd	暌	*+
djr 	奔	*+
dju 	豉	*+
dk  	裂	*+
dke 	旺	*+
dkh 	恳	*+
dki 	昕	*+
dkl 	旯	*+
dkn 	艮	*+
dkn 	暌	*+
dkoe	殛	*+
dkw 	退	*+
dkx 	残	*+
dkx 	旯	 +
dky 	垦	*+
dkz 	旯	*+
dl  	既	*+
dl  	曷	*+
dla 	晒	*+
dla 	了	 +
dlb 	昃	*+
dld 	暗	*+
dle 	昱	*+
dlk 	旷	*+
dllb	晒	 +
dln 	闹	*+
dln 	曩	*+
dlob	颢	*+
dlok	曩	*+
dlom	影	 +
dlop	暾	*+
dlos	景	 +
dlos	晾	 +
dlot	颢	*+
dlp 	旷	*+
dlrb	旷	 +
dls 	景	 +
dls 	晾	*+
dlsb	颢	*+
dlsm	影	 +
dlst	颢	*+
dlzp	暾	*+
dm  	影	*+
dm  	晦	*+
dmb 	负	*+
dmd 	勖	*+
dme 	殂	*+
dmo 	冒	*+
dmv 	晦	*+
dn  	大	*+
dnb 	昀	*+
dnbf	鹖	 +
dnbi	歇	 +
dnbl	曷	 +
dnbw	遏	 +
dnc 	晕	*+
dnc 	晖	*+
dncb	殡	 +
dncp	豌	*+
dncr	晚	 +
dncr	冕	 +
dnd 	殉	*+
dndl	暝	*+
dne 	暄	*+
dnee	暄	 +
dnf 	鹖	*
dng 	晏	*+
dnkb	殡	 +
dnlb	曷	 +
dnlf	鹖
dnli	歇	 +
dnlw	遏	 +
dnm 	易	 +
dnmr	剔	 +
dnof	煦	*+
dnpb	殡	 +
dnr 	昀	*+
dns 	牵	*+
dnsb	殡	 +
dnu 	殁	*+
do  	日	*+
do  	曰	*+
doa 	殓	*+
dob 	邵	*+
dod 	劭	*+
dofu	暇	 +
doj 	殚	*+
dolk	袈	*+
domb	贺	 +
domb	殒	*+
domf	驾	 +
doo 	加	*+
doo 	召	 +
dooj	殚	 +
dot 	架	*+
doto	哿	*+
dow 	迢	*+
dow 	迦	*+
dox 	暇	*+
do, 	ど	*+
do. 	ド	*+
dp  	刀	*+
dpbo	晷	*+
dpfj	晔	 +
dpi 	卯	*+
dpno	晌	*+
dppo	晷	*+
dq  	量	*+
dqb 	昧	*+
dqer	晓	 +
dql 	奄	 +
dqlf	鹌	*+
dqo 	奋	*+
dr  	晚	*+
dra 	晁	*+
drb 	哄	*+
drbb	晁	 +
drbw	暴	 +
dre 	夳	*+
drf 	烈	*+
dri 	列	*+
drj 	耷	*+
drjq	晔	 +
drk 	夸	*+
drkg	瓠	 +
drkl	匏	*+
drkn	匏	*+
drkr	刳	*+
drlk	裂	 +
drs 	奈	*+
dru 	最	*+
dru 	殁	 +
drv 	冕	*+
ds  	景	*+
dsaq	戥	*+
dsb 	殊	*+
dse 	星	*+
dser	晃	*+
dsi 	夼	*+
dsqj	殚	 +
dss 	殊	*+
dt  	题	*+
dta 	头	*+
dta 	昙	 +
dta 	颛	 +
dtk 	晰	*+
dtmb	头	 +
dtmb	颛	 +
dtn 	杲	*+
dto 	奇	*+
dtoi	欹	*+
dtor	剞	 +
du  	渡	*+
due 	明	*+
duf 	盟	*+
duk 	既	 +
duke	暨	 +
duo 	殆	*+
dup 	即	 +
dut 	昙	*+
du, 	づ	*+
du. 	ヅ	*+
dv  	召	*+
dv  	曜	*+
dva 	夺	 +
dvdm	殇	 +
dve 	殇	*+
dvf 	昨	*+
dvm 	旸	*
dvom	晦	 +
dvq 	奋	*+
dvv 	曜	*+
dvw 	暹	*+
dvwm	殇	 +
dw  	边	*+
dw  	遏	*+
dwm 	阳	*+
dwm 	旸
dwn 	达	*+
dwn 	逗	*+
dwn 	边	 +
dwn 	遏	 +
dwn 	遄	 +
dwnv	逗	*+
dwnv	边	 +
dwnv	遏	 +
dwnv	遄	 +
dwo 	晤	*+
dwoe	殛	*+
dwv 	遏	*+
dwwb	显	 +
dwwt	显	 +
dx  	力	*+
dxj 	升	 +
dxn 	飧	*+
dxxn	曦	*+
dxxx	爽	*+
dy  	力	*+
dya 	时	 +
dyd 	暑	*+
dyd 	奢	 +
dynd	殪	*+
dypd	暑	 +
dypd	奢	 +
dyr 	晓	*+
dys 	昧	*+
dyy 	奎	*+
dyym	旸
dyyr	晓	 +
dz  	暴	*+
e   	一	*+
ea  	将	*+
eaa 	寻	*+
eaa 	兔	*+
eaa 	酎	*+
eadf	然	 +
eadk	酿	 +
eagu	酦	*
eai 	嵛	*+
eai 	嵚	*+
eal 	酏	*+
ealu	酦	*
eam 	仑	*+
ean 	酿	*+
eap 	岭	*+
eapb	岭	 +
eapt	岭	 +
eaqg	崴	*+
ease	崄	*+
eat 	岭	*+
eatb	岭	 +
eatt	岭	 +
eaur	嵛	 +
eaw 	逸	 +
eaxf	鹉	 +
eaxr	贰	 +
eaxu	酦	*+
eaxz	武	 +
eay 	岑	*+
eazr	虢	*+
eb  	两	*+
eb  	翼	*+
eba 	两	 +
eba 	乊	*
ebbo	峪	 +
ebbu	嵴	*+
ebd 	酚	*+
ebe 	嶝	*+
ebew	嵫	*+
ebh 	酴	*+
ebhi	嵯	*+
ebi 	那	*+
ebi 	村	 +
ebi 	邴	*+
ebki	嵯	*+
ebn 	两	 +
ebp 	两	 +
ebp 	乊	*
ebru	嵴	*+
ebv 	翼	*+
ec  	融	*+
eca 	岁	*+
eca 	蚩	 +
ecee	崛	*+
ecee	翙	*+
eceu	崛	*+
ecf 	死	*+
ecg 	崾	*+
eck 	崭	*+
ecl 	爬	*+
ecl 	岜	*+
ecm 	嵋	*+
eco 	酩	*+
ecr 	刿	*+
ecs 	岽	*+
ed  	岂	*+
eda 	酞	*+
edb 	昆	*+
edb 	醌	*+
edc 	蚕	*+
ede 	岂	 +
ede 	昼	 +
ede 	亘	*+
ede 	岙	 +
edez	醍	 +
edf 	酝	*+
edf 	忝	 +
edh 	忝	*+
edil	腌	 +
edil	崦	 +
edmr	觊	*+
edn 	天	*+
edo 	书	*+
edo 	吞	 +
edoo	乔	 +
edp 	峁	*+
edql	腌	 +
edql	崦	 +
edr 	凯	*+
edr 	剀	*+
eds 	醒	*+
edto	崎	 +
edx 	勉	*+
edy 	勉	*+
ee  	习	*+
ee  	丑	 +
eea 	酹	*+
eeaa	酾	 +
eebf	鹨	*+
eebq	戮	 +
eec 	蚩	*+
eee 	羽	*+
eee 	峥	 +
eeem	醪	 +
eefl	酽	 +
eei 	出	*+
eej 	争	*+
eejj	翠	*+
eel 	翌	*+
eem 	醪	*+
eem 	粜	 +
eenc	翚	*+
eep 	羽	*+
eepd	习	 +
eeqb	翼	 +
eer 	羿	*+
eers	祟	*+
eev 	翟	*+
eevq	戳	*+
ee, 	─	*+
ef  	灵	*+
efaa	爵	*+
efb 	醭	*+
efbu	嵴	*+
efd 	酯	*+
efd 	醴	*+
efda	爵	*+
efe 	亚	 +
efed	晋	 +
efed	醭	 +
efeh	恶	 +
efeq	戬	*+
efey	垩	*+
eff 	尽	*+
effd	崂	*+
efft	嵘	*+
efl 	配	*+
efl 	岂	 +
efl 	严	 +
efl 	屺	*+
eflr	凯	 +
eflr	剀	 +
eflr	觊	 +
efn 	灭	*+
efn 	灵	 +
efoo	岖	 +
efu 	醐	*+
efv 	焉	*+
efvz	嶷	*+
efx 	岖	*+
efy 	峄	*+
efyg	峄	 +
eg  	妥	*+
ege 	舀	*+
egfs	嵊	*+
egg 	岍	*+
egi 	嵌	*+
egi 	峤	*+
egj 	酐	*+
egn 	峡	*+
egno	峤	*+
egnr	峤	*+
ego 	酣	*+
ego 	峤	*+
egqf	醺	*+
egu 	爰	*+
egx 	妥	 +
egys	嵊	*+
eh  	群	*+
ehgu	巍	*+
ehgv	巍	*+
ehi 	肃	*+
ehj 	举	 +
ehn 	酥	*+
ehnf	鹔	*+
ehp 	肃	*+
ehv 	峻	 +
ehx 	酸	*+
ehx 	峻	 +
ei  	山	*+
ei  	爪	*+
ein 	欤	*+
eio 	誉	*+
eioa	寻	 +
eiq 	岫	*+
eix 	峨	*+
ej  	扭	*+
ej  	聿	*+
ej  	帚	*+
ejbb	巅	*+
ejbt	巅	*+
ejd 	嶝	*+
ejj 	醉	*+
ejmb	巅	*+
ejmt	巅	*+
ejn 	醍	*+
ejo 	岵	*+
ejo 	酤	*+
ejou	醐	 +
ejqu	拨	 +
eju 	岐	*+
ek  	长	*+
eke 	屿	*+
ekj 	岍	*+
ekl 	无	*+
ekn 	长	 +
el  	屯	*+
el  	免	*+
ela 	酾	*+
eldj	嶂	*+
eleo	醣	*+
elf 	炭	*+
elg 	岸	*+
elho	嵩	 +
eln 	酿	*+
eln 	崃	*+
elno	嵩	 +
elo 	岩	*+
elo 	醅	*+
elok	酿	 +
eloo	嵩	 +
eloz	醇	 +
eloz	崞	 +
elp 	屵	*+
elv 	免	*+
elyy	崖	*+
elz 	醇	*+
elz 	崞	*+
em  	彩	*+
emaq	戮	 +
emc 	嶙	*+
emcs	嶙	 +
emg 	嵝	*+
emnf	鹨	*+
emr 	觅	*+
emr 	岘	*+
emw 	醚	*+
en  	夷	*+
en  	爪	*+
en  	丙	*+
ena 	酌	*+
enap	爱	 +
enau	爱	 +
enb 	丙	*+
enb 	管	 +
enbb	两	 +
enbb	邴	 +
enbe	岗	 +
enbi	崆	*+
enc 	舜	*+
encs	舜	 +
end 	峋	*+
ene 	峥	*+
eneo	峒	*+
eneo	酮	*+
enf 	酡	*+
enhp	爱	 +
enn 	帚	*+
eno 	岣	*+
enri	崆	*+
enrs	崇	 +
ens 	崇	*+
enu 	受	*+
enw 	迈	*+
enw 	迎	 +
enx 	岗	*+
enxu	爱	 +
eny 	再	 +
eo  	司	*+
eo  	酉	*+
eob 	郡	*+
eobf	酝	 +
eobh	群	 +
eojo	崮	*+
eok 	酲	*+
eol 	酽	*+
eonc	融	 +
eone	翮	*+
eonf	鹝	*+
eont	鬲	*+
eoo 	君	*+
eoop	酽	 +
eop 	酽	*+
eoqr	副	 +
eoqw	逼	 +
eox 	岷	*+
eox 	酽	 +
ep  	易	*+
epbn	岿	 +
epdo	峤	*+
epdr	峤	*+
epf 	峰	*+
epi 	印	*+
epo 	酪	*+
eppa	卵	*+
eppz	孵	*+
epqu	丑	 +
epqu	嵬	 +
epu 	岌	*+
epv 	峻	 +
eq  	家	*+
eqaf	鸡	 +
eqdh	恳	 +
eqdo	貂	*+
eqdy	垦	 +
eqe 	画	*+
eqee	豳	*+
eqef	燹	*+
eqer	划	 +
eqer	峣	*+
eqeu	豳	*+
eqgr	貌	 +
eqgw	邈	*+
eqh 	崽	*+
eqh 	猪	 +
eqi 	岬	*+
eqid	岳	 +
eqiu	豳	*+
eqj 	举	 +
eqj 	豮	*
eqjb	豮	*+
eqjp	豺	 +
eqn 	豕	*+
eqna	豹	*+
eqnf	鸡	 +
eqo 	嵩	*+
eqp 	豸	*+
eqpb	貔	*+
eqpo	貉	*+
eqpr	貌	 +
eqpt	貅	*+
eqpw	邈	*+
eqq 	狸	*+
eqrd	貘	*+
eqrq	猫	 +
eqtd	貊	*+
equ 	画	*+
equ 	豺	 +
eqw 	逐	*+
eqyd	猪	 +
eqyt	橥	*+
er  	副	*+
erbk	醛	*+
erbr	尬	 +
erc 	岚	*+
erc 	虺	*+
erd 	醋	*+
ere 	岿	*+
eri 	剔	*+
eri 	丌	*+
erl 	兀	*+
ern 	岌	*+
ernd	崂	*+
ernt	嵘	*+
erod	醴	*+
errf	尴	 +
errs	萧	 +
ers 	肃	*+
ersf	鹔	*
ert 	颛	*+
ertb	颛	 +
eru 	段	 +
erv 	貌	*+
erw 	遄	*+
erww	嵫	*+
erx 	岚	*+
es  	纽	*+
esa 	系	 +
esib	颈	 +
esid	劲	 +
esir	刭	 +
esis	巯	*+
esit	颈	 +
esiw	迳	 +
esnd	崂	*+
eso 	酷	*+
esr 	肃	*+
esr 	酰	*+
esrf	鹔	*
esu 	峭	*+
esv 	舜	*+
et  	峻	*+
eta 	顿	*+
eta 	酝	 +
etbu	崧	*+
etcn	释	 +
etfg	释	 +
etfy	释	 +
eth 	悉	*+
eti 	酊	*+
eti 	亍	 +
etm 	彩	 +
etmb	顿	 +
etn 	采	*+
etnb	颛	 +
etnl	乱	 +
etnl	辞	 +
etnr	端	 +
etnt	颛	 +
etnw	遄	 +
eto 	岢	*+
etsf	醯	*+
etuq	释	 +
eu  	段	*+
eua 	酹	*+
eubp	酸	 +
eubp	峻	 +
eue 	肆	*+
euf 	肆	*+
eui 	出	*+
eum 	粜	*+
eum 	髟	 +
euq 	峄	*+
eurp	酸	 +
eurp	峻	 +
eurs	祟	*+
euu 	崩	*+
euud	晋	 +
ev  	丑	*+
eva 	丑	 +
eva 	嵬	*+
eve 	崔	*+
evf 	醮	*+
evf 	酢	*+
evn 	醭	*+
evo 	崎	*+
evom	酶	*+
evox	酶	*+
evx 	崾	*+
evz 	屹	*+
ev, 	ぇ	*+
ev. 	ェ	*+
ew  	遥	*+
ew  	逼	*+
ewa 	录	*+
ewa 	隶	*+
ewd 	奚	*+
ewdf	鸡	 +
ewdo	溪	 +
ewdv	鸡	 +
ewef	盥	 +
ewf 	为	 +
ewn 	建	*+
ewn 	录	 +
ewn 	隶	*+
ewo 	峪	*+
ewr 	剥	*+
ewuf	鹞	*+
ewus	繇	*+
ewuw	遥	 +
ewux	飖	*+
eww 	逮	*+
eww 	逯	*+
ex  	尹	*+
ex  	爰	*+
exf 	炭	*+
exl 	腌	*+
exl 	崦	*+
exof	醢	*+
exp 	岈	*+
exu 	酗	*+
exxu	崤	*+
ey  	再	*+
eya 	峙	*+
eye 	岿	*+
eyp 	岈	*+
eypz	酵	*+
eyy 	酬	 +
eyyy	酬	 +
eyzu	醑	*+
ez  	正	*+
ezb 	郛	*+
eze 	正	 +
ezeq	醵	 +
ezj 	孚	*+
ezkb	鄢	*+
ezkf	焉	 +
ezl 	乳	*+
ezn 	醵	*+
ezp 	政	*+
e,  	え	*+
e,  	ぇ	*+
e,  	ゑ	*+
e,  	へ	*+
e.  	エ	*+
e.  	ェ	*+
e.  	ヱ	*+
e.  	ヘ	*+
f   	四	*+
fa  	下	*+
faa 	寿	*+
faa 	对	 +
fad 	烩	*+
fad 	戾	*+
fado	炝	 +
faf 	焘	*+
faj 	烨	*+
fak 	炷	*+
faqd	烩	 +
fav 	对	*+
fayo	焓	*+
fb  	旗	*+
fba 	典	*+
fba 	罘	*+
fbb 	於	*+
fbb 	于	 +
fbc 	蛋	*+
fbe 	灯	*+
fbew	燧	*+
fbh 	烊	*+
fbi 	邦	*+
fbi 	邙	*+
fbi 	邡	*+
fbmr	觍	*+
fbn 	帮	*+
fbn 	疋	*+
fbo 	罾	*+
fbp 	炝	*+
fbqd	罾	 +
fbs 	烂	*+
fbt 	烩	*+
fbu 	脊	*+
fbu 	胥	 +
fbuf	鹡	*
fc  	烛	*+
fc  	艳	*+
fca 	罗	*+
fca 	烛	 +
fceb	匮	 +
fck 	匦	*+
fcnb	烬	*+
fcs 	炼	*+
fcv 	艳	*+
fcw 	逻	*+
fcy 	烟	*+
fd  	族	*+
fdb 	酆	*+
fdbs	燎	 +
fdc 	艳	*+
fdd 	契	*+
fddc	艳	 +
fddq	熘	 +
fde 	丰	 +
fdem	炀	 +
fdfu	熳	 +
fdg 	焊	*+
fdg 	焰	 +
fdgb	郾	*+
fdh 	挈	*+
fdh 	恝	*+
fdil	罨	 +
fdj 	戽	*+
fdkw	煺	*+
fdl 	煜	*+
fdnc	艳	 +
fdnl	艳	 +
fdo 	旨	*+
fdql	罨	 +
fdrw	爆	 +
fdv 	侯	*+
fdyf	艳	 +
fdzu	啮	*+
fe  	上	*+
fe  	皿	*+
feaf	燃	 +
feb 	邺	*+
feba	对	 +
feba	凿	 +
febb	邺	 +
febg	丵	*+
febl	业	 +
febt	业	 +
febu	凿	*+
febu	丛	 +
fee 	业	 +
fee 	扇	*+
feed	熠	*+
fefa	爝	*+
feff	烬	*+
fegu	暖	 +
fei 	灿	*+
fel 	炖	*+
fen 	炳	*+
fenb	炳	 +
feof	鹮	*
feow	还	 +
fep 	炀	*+
ferl	业	 +
fert	业	 +
feru	煅	*+
fesa	黻	*+
fesi	烃	 +
fesi	黼	 +
fesq	黼	*+
fess	黹	*+
fesu	黻	*+
fev 	皿	*+
fex 	暖	*+
feyh	殷	*+
feyu	殷	*+
fez 	罡	*+
ff  	北	*+
ffb 	邶	*+
ffb 	郯	*+
ffe 	巨	*+
ffe 	彗	*+
ffeb	酆	 +
ffec	艳	 +
ffed	丰	 +
ffee	煽	*+
ffef	艳	 +
ffeh	慧	 +
ffel	艳	 +
fff 	炬	*+
fff 	焱	*+
fffc	飚	*+
fffx	飚	*+
ffk 	农	 +
ffl 	北	 +
ffm 	匾	*+
ffm 	煸	*+
ffn 	炎	*+
ffna	莹	*+
ffnc	烛	 +
ffnc	萤	 +
ffnd	劳	 +
ffnf	荧	 +
ffnf	莺	 +
ffno	营	 +
ffns	萦	 +
ffns	荦	 +
ffnt	荣	 +
ffny	茔	*+
ffo 	巨	*+
ffp 	炉	*+
ffqb	冀	*+
ffr 	剡	*+
ffs 	烁	*+
fft 	颎	*
fftb	颎	 +
ffu 	背	*+
ffu 	煳	*+
ffy 	房	*+
ffy 	堃	*+
ffy 	巪	*+
fg  	己	*+
fgia	凿	*+
fgiu	毁	 +
fgqf	熏	 +
fgra	凿	*+
fgt 	煤	*+
fgx 	妄	*+
fgyu	毁	 +
fh  	慧	*+
fha 	忘	*+
fha 	忐	*+
fha 	忑	*+
fhj 	烀	*+
fho 	署	*+
fht 	颖	*+
fhtb	颖	 +
fhv 	罹	*+
fi  	欧	*+
fifb	酆	 +
fifc	艳	 +
fifd	丰	 +
fiff	艳	 +
fifl	艳	 +
fifp	燮	*+
fifu	燮	*+
fii 	厅	*+
fin 	炊	*+
fio 	詈	*+
fir 	罚	*+
fj  	丰	*+
fj  	飞	*+
fj  	丯	*+
fjd 	灯	*+
fje 	置	*+
fjf 	燃	*+
fjl 	置	*+
fjme	置	 +
fjml	置	 +
fjn 	炔	*+
fjnf	鸨	*+
fjng	罱	*+
fjo 	罟	*+
fjou	煳	*+
fjqs	炼	 +
fk  	断	*+
fka 	辱	*+
fkc 	蜃	*+
fkd 	匡	*+
fke 	匡	*+
fki 	所	*+
fki 	匠	 +
fkk 	丐	*+
fkn 	辰	*+
fko 	唇	*+
fku 	唇	*+
fkv 	匠	*+
fl  	亡	*+
fl  	匕	*+
fl  	匚	*+
fla 	燎	*+
flad	炽	 +
flfb	巽	*+
flfw	选	 +
flh 	忌	*+
flhp	炖	 +
fll 	已	*+
fll 	己	 +
flno	熵	 +
flo 	焙	*+
flo 	炻	*+
flo 	砉	 +
flop	炖	 +
flp 	改	*+
flr 	炕	*+
flr 	异	 +
flt 	燥	*+
flv 	匕	*+
flw 	炫	*+
flzp	炖	 +
fm  	督	*+
fmb 	买	 +
fmc 	磷	*+
fmcs	烂	 +
fmcs	磷	 +
fmee	翩	*+
fmf 	骂	*+
fmh 	焖	*+
fmj 	扁	*+
fmjs	烂	 +
fmk 	众	*+
fmlb	真	 +
fmn 	烂	*+
fmo 	盲	*+
fmq 	燔	*+
fmw 	遍	*+
fmx 	熳	*+
fn  	火	*+
fn  	奏	*+
fna 	灼	*+
fnbb	众	 +
fnbf	燃	 +
fnbo	熔	 +
fnbo	炯	 +
fnc 	蜀	*+
fnc 	艳	 +
fnc 	焕	*+
fncl	艳	 +
fnd 	春	*+
fnd 	励	 +
fndc	蠢	*+
fne 	煊	*+
fned	奏	 +
fnee	煊	 +
fnfb	焕	*+
fng 	焰	*+
fng 	舂	*+
fngn	奏	 +
fnh 	秦	*+
fni 	匝	*+
fnj 	匝	*+
fnj 	罱	*+
fnl 	炮	*+
fnn 	带	 +
fnnd	焕	*+
fno 	炯	*+
fno 	扃	*+
fnob	焕	*+
fnol	炮	 +
fnpd	奏	 +
fnq 	奉	*+
fnrf	燃	 +
fnro	炯	 +
fnrr	烷	*+
fnw 	泰	*+
fnw 	熔	 +
fny 	厉	*+
fo  	曲	*+
fob 	炽	*+
foc 	扈	*+
focl	扈	 +
fod 	烟	*+
foo 	启	*+
foo 	叵	 +
foo 	后	 +
foo 	後	*+
foof	鸥	*+
fooi	欧	 +
fooo	区	 +
foot	燥	 +
foou	殴	*+
foow	瓯	 +
fop 	启	*+
foq 	熘	*+
foua	赢	 +
foua	嬴	 +
foua	羸	 +
fouz	赢	 +
fouz	嬴	 +
fouz	羸	 +
fov 	叵	*+
fow 	逅	*+
fox 	氓	*+
fp  	户	*+
fpa 	卡	*+
fpbb	众	 +
fpdk	煌	*+
fpdr	兜	*+
fpe 	肇	*+
fpf 	烽	*+
fpfj	烨	 +
fph 	熄	*+
fpl 	卮	*+
fpmh	熄	 +
fpnd	燠	*+
fpo 	烙	*+
fpo 	启	 +
fpob	燠	*+
fps 	綮	*+
fpw 	迎	*+
fpx 	放	*+
fq  	幅	*+
fqa 	匮	*+
fqer	烧	 +
fqi 	匣	*+
fqj 	罩	*+
fqj 	焯	*+
fqk 	煨	*+
fqn 	众	*+
fr  	业	*+
frb 	烘	*+
frcf	羁	*+
frjq	烨	 +
frk 	烤	*+
frl 	匹	*+
frn 	烁	*+
fro 	匿	*+
froh	慝	*+
frrj	烨	 +
frsb	颖	 +
frsb	颕	*+
frss	罪	 +
frss	匪	 +
frss	扉	 +
frst	颖	 +
frst	颕	*
fru 	丛	*+
frxh	慝	*+
frxo	匿	 +
fs  	匪	*+
fsa 	乐	*+
fsb 	邺	*+
fsi 	烃	*+
fsn 	乐	*+
fsn 	业	 +
fsp 	炒	*+
fsu 	叔	*+
fsum	督	 +
fsv 	罗	*+
fsvw	逻	 +
ft  	顷	*+
ft  	烦	*+
fta 	烦	*+
fta 	顷	 +
fti 	灯	*+
ftmb	烦	 +
ftmb	顷	 +
ftnb	炳	 +
ftv 	烦	*+
fu  	胡	*+
fuaf	燃	 +
fuba	羸	*+
fubz	羸	*+
fuca	蠃	*+
fucz	蠃	*+
fue 	肩	*+
fue 	肓	 +
fuga	嬴	*+
fugz	嬴	*+
fui 	烃	*+
fuk 	望	*+
ful 	罢	*+
fuma	赢	 +
fumz	赢	 +
funf	鹕	*+
fuuf	罢	 +
fuv 	肓	*+
fux 	麦	 +
fuy 	烃	*+
fu, 	ふ	*+
fu. 	フ	*+
fv  	区	*+
fva 	施	*+
fvcf	旎	*+
fvd 	医	*+
fvde	肄	*+
fvde	医	 +
fvde	翳	*+
fvdf	鹥	*+
fvdi	款	 +
fvdo	旖	 +
fvdz	疑	 +
fve 	雇	*+
fvf 	炸	*+
fvfb	旋	 +
fvjn	旆	*+
fvk 	旅	*+
fvkb	旗	 +
fvku	膂	*+
fvln	旆	*+
fvm 	旄	*+
fvne	旃	*+
fvnl	旃	*+
fvnl	匦	 +
fvs 	旌	*+
fvt 	顾	 +
fvtb	顾	 +
fvts	旒	*+
fvv 	旖	*+
fvvd	族	 +
fvyz	旋	 +
fvzw	游	 +
fw  	爆	*+
fwj 	炜	*+
fwm 	炀	*+
fwn 	游	 +
fwn 	旆	*+
fwo 	焐	*+
fwos	炜	 +
fwpt	烁	 +
fwt 	颍	*+
fwtb	颍	 +
fwv 	汇	*+
fwwk	断	 +
fx  	发	*+
fxi 	欧	 +
fxl 	罨	*+
fxnf	鸥	*+
fxo 	熵	*+
fxru	殴	*+
fxw 	瓯	*+
fxx 	区	 +
fxxn	烯	*+
fy  	方	*+
fybg	睾	 +
fyd 	署	*+
fye 	灶	*+
fyj 	睾	*+
fypa	卵	*+
fypd	署	 +
fypk	烤	 +
fypz	孵	*+
fyr 	烧	*+
fyu 	罢	*+
fyuf	罴	*+
fyyr	烧	 +
fz  	疑	*+
fz  	旋	*+
fzcm	灿	 +
fzdj	罩	 +
fzdj	焯	 +
fzqf	炉	 +
fzv 	旋	*+
g   	干	*+
ga  	瓜	*+
gad 	状	*+
gada	妫	 +
gadk	娘	 +
gal 	她	*+
gan 	娘	*+
gaq 	戕	*+
gav.	ヵ	*+
gay 	妗	*+
ga, 	が	*+
ga. 	ガ	*+
ga. 	ヵ	*+
gb  	俱	*+
gbef	嫌	 +
gbi 	郑	*+
gbi 	邯	*+
gbi 	邮	 +
gbi 	邗	*+
gbi 	郏	*+
gbk 	姘	*+
gbl 	妣	*+
gbn 	臾	*+
gbqj	婵	 +
gbqp	娣	 +
gbto	婀	*+
gbv 	嫔	*+
gbwf	妫	 +
gc  	奖	*+
gca 	将	 +
gca 	麦	 +
gcac	螀	*
gcad	奖	 +
gcd 	奖	 +
gce 	酱	*+
gceb	舆	 +
gcf 	妮	*+
gcm 	媚	*+
gcm 	娓	*+
gcnm	麴	*+
gcqn	麸	*+
gcrs	嫖	*+
gct 	桨	*+
gcth	面	 +
gcto	面	 +
gcty	面	 +
gcw 	浆	*+
gd  	娱	*+
gdcr	娩	 +
gdd 	娼	*+
gde 	妲	*+
gdf 	媪	*+
ge  	垂	*+
ge  	臼	*+
gea 	将	 +
gead	奖	 +
geae	酱	 +
geat	桨	 +
geaw	浆	 +
geb 	娜	*+
gec 	媸	*+
gedo	娇	 +
gee 	妇	*+
gee 	妞	*+
geec	媸	 +
gefe	娅	 +
gegu	媛	 +
gej 	妇	*+
gek 	妩	*+
gel 	娩	*+
gen 	姨	*+
genn	妇	 +
genp	嫒	 +
genu	嫒	 +
ges 	秉	*+
gev.	ヶ	*+
gewf	妫	 +
gex 	媛	*+
gezf	嫣	*+
ge, 	げ	*+
ge. 	ゲ	*+
ge. 	ヶ	*+
gf  	驾	*+
gfbu	婿	*+
gff 	乖	*+
gffr	剩	 +
gffs	乘	 +
gfk 	娠	*+
gfl 	妃	*+
gfoo	妪	 +
gfp 	妒	*+
gfx 	妪	*+
gfy 	妨	*+
gg  	婢	*+
ggg 	奸	*+
ggi 	娇	*+
ggi 	歃	*+
ggiu	嫂	 +
ggj 	奸	*+
ggl 	妩	*+
ggn 	妖	*+
ggno	娇	 +
ggnr	娇	 +
ggo 	娇	*+
ggt 	媒	 +
ggu 	嫂	*+
ggv 	婢	 +
ggx 	妆	*+
gh  	怒	*+
ghk 	婊	*+
ghu 	婧	*+
ghx 	嫒	*+
gi  	即	*+
gi  	乔	*+
gi  	爿	*+
gi  	丩	*+
gigu	嫂	 +
giq 	妯	*+
giqk	娉	 +
giru	毁	 +
giu 	叟	*+
gix 	娥	*+
gi, 	ぎ	*+
gi. 	ギ	*+
gj  	千	*+
gj  	干	 +
gjbo	嫱	*+
gjcp	嫩	*+
gje 	媾	*+
gjez	婕	 +
gjjb	邮	 +
gjjy	垂	 +
gjny	媾	 +
gjo 	姑	*+
gjp 	姊	*+
gjqb	姨	 +
gju 	妓	*+
gjz 	婕	*+
gk  	装	*+
gke 	妊	*+
gkj 	妍	*+
gl  	辞	*+
gl  	乇	*+
glbd	嫉	*+
gldj	嫜	*+
glht	婷	 +
gll 	无	*+
gln 	娘	*+
glno	嫡	 +
glnt	婷	 +
gloe	嬗	*+
glok	娘	 +
glom	嬗	*+
glot	婷	 +
gltu	嬷	*+
gltw	嬷	*+
glvd	嫉	*+
glx 	姣	*+
gm  	妈	*+
gme 	姐	*+
gmf 	妈	 +
gmj 	姗	*+
gmt 	娴	*+
gn  	关	*+
gn  	夹	 +
gn  	瓜	 +
gna 	妁	*+
gnc 	蚕	*+
gncb	嫔	 +
gncp	婉	*+
gncr	娩	 +
gne 	岙	*+
gneq	嫁	*+
gnf 	忝	*+
gnf 	鹫	*+
gnf 	舄	*+
gng 	姹	*+
gnh 	忝	*+
gni 	婶	*+
gnii	婶	 +
gnkb	嫔	 +
gnlk	袅	*+
gnmq	婶	 +
gnn 	天	*+
gnn 	夭	*+
gnne	姗	 +
gno 	吞	*+
gnoo	乔	 +
gnpb	嫔	 +
gnr 	乔	*+
gnr 	姗	 +
gns 	你	*+
gnsb	嫔	 +
gnv 	夹	 +
go  	甘	*+
go  	舌	*+
gobf	媪	 +
god 	姻	*+
goe 	娅	*+
goed	娱	 +
goef	舔	*+
goeh	舔	*+
gog 	甜	*+
gogf	舔	*+
gogh	憩	*+
gogh	舔	 +
gogn	娱	 +
goh 	恕	*+
goj 	婵	*+
gokb	娱	 +
gokd	娱	 +
gol 	乱	*+
gol 	辞	 +
gom 	姆	*+
gonb	娲	 +
gonb	娱	 +
gonf	鸹	*+
goo 	如	*+
goo 	舌	 +
gooj	婵	 +
gop 	敌	*+
gopf	舔	*+
goph	憩	*+
goph	舔	 +
gor 	刮	*+
gos 	絮	*+
gou 	娟	*+
gow 	适	*+
gox 	舐	*+
go, 	ご	*+
go. 	ゴ	*+
gp  	教	*+
gp  	爿	*+
gpd 	妖	*+
gpdo	娇	 +
gpdr	娇	 +
gpe 	侄	*+
gpg 	婢	 +
gph 	媳	*+
gpmh	媳	 +
gpnm	麴	*+
gpob	媲	*+
gpqg	婢	 +
gpqn	麸	*+
gpth	面	 +
gpto	面	 +
gpty	面	 +
gpx 	收	*+
gpx 	麦	 +
gq  	重	*+
gqb 	妹	*+
gqd 	舅	*+
gqd 	动	 +
gqdf	勋	*+
gqe 	重	 +
gqe 	娌	*+
gqer	娆	 +
gqf 	熏	*+
gqfd	勋	*+
gqk 	娉	*+
gqn 	嫌	*+
gqo 	娲	*+
gqs 	嫘	*+
gr  	剩	*+
gra 	姚	*+
grbb	姚	 +
grdd	嫫	*+
gre 	姬	*+
gri 	刊	*+
gri 	刾	*+
grj 	舁	*+
grl 	儿	 +
grp 	奶	*+
gry 	垂	 +
gs  	乘	*+
gsb 	姝	*+
gsbd	鼢	*+
gsdg	鼹	*+
gsdo	貂	*+
gse 	姓	*+
gsed	鼷	*+
gsfg	鼹	*+
gsiq	鼬	*+
gsl 	鼠	*+
gsn 	鼠	*+
gsn 	瓞	*+
gsnn	嫦	*+
gsp 	妙	*+
gss 	姝	*+
gswo	鼯	*+
gt  	媒	*+
gta 	颊	*+
gta 	顸	*+
gtmb	颊	 +
gtmb	顸	 +
gtn 	某	*+
gtn 	床	 +
gtp 	娣	*+
gtv 	婷	*+
gu  	毁	*+
gua 	将	 +
guac	螀	*+
guad	奖	 +
guae	酱	 +
guat	桨	 +
guaw	浆	 +
gub 	姒	*+
gud 	努	*+
guh 	怒	 +
gui 	妤	*+
gumf	驽	*+
gun 	帑	*+
gunb	胬	*+
guo 	始	*+
guq 	弩	*+
gutm	孀	*+
gux 	奴	*+
gux 	叟	 +
guz 	孥	*+
gu, 	ぐ	*+
gu. 	グ	*+
gv  	夹	*+
gvff	妩	 +
gvsp	嫩	*+
gw  	迁	*+
gwa 	妫	*+
gwf 	盥	*+
gwn 	送	*+
gwn 	迁	 +
gwoo	墙	*+
gwoo	嫱	 +
gwv 	迁	 +
gx  	女	*+
gxd 	婚	*+
gxo 	嫡	*+
gy  	旁	*+
gyd 	奘	*+
gydo	嬉	*+
gye 	壮	*+
gylk	装	 +
gyoo	嬉	*+
gypf	姥	*+
gyr 	娆	*+
gyru	毁	 +
gys 	妹	*+
gyy 	娃	*+
gyyr	娆	 +
gyzu	婿	*+
gz  	好	*+
gzj 	好	 +
h   	时	*+
ha  	心	*+
haa 	忖	*+
hadk	稂	 +
hado	怆	 +
hai 	愉	*+
hak 	忧	*+
hakd	稽	*+
hake	嵇	*+
han 	稂	*+
hao 	恰	*+
haoh	搿	*+
hap 	怜	*+
haqe	馘	 +
haqh	憾	 +
hat 	怜	*+
hat 	怵	*+
hat 	秫	*+
haur	愉	 +
hayh	稔	*+
ha, 	は	*+
ha. 	ハ	*+
hb  	惧	*+
hba 	怀	*+
hbbe	忏	 +
hbdh	掰	*+
hbef	慊	 +
hbi 	都	 +
hbl 	秕	*+
hbo 	憎	*+
hbor	税	 +
hbor	悦	 +
hbp 	怆	*+
hbqd	憎	 +
hbqj	惮	 +
hbqp	悌	 +
hbu 	忪	*+
hbv 	懒	*+
hbw 	黍	*+
hbwo	黏	*+
hc  	程	*+
hc  	秧	*+
hcc 	移	*+
hceb	愦	 +
hcf 	怩	*+
hch 	穗	*+
hci 	种	*+
hci 	忡	*+
hcj 	种	*+
hcj 	忡	*+
hck 	惭	*+
hcn 	怏	*+
hcn 	秧	 +
hcqn	麸	*+
hct 	栗	*+
hcuh	穗	 +
hcv 	秧	*+
hd  	懊	*+
hdae	恒	 +
hdbw	黎	 +
hdd 	契	*+
hde 	怛	*+
hdf 	愠	*+
hdfu	慢	 +
hdg 	悍	*+
hdg 	秆	*+
hdh 	挈	*+
hdh 	恝	*+
hdi 	惴	*+
hdj 	科	*+
hdk 	恨	*+
hdl 	慨	*+
hdls	憬	*+
hdnm	惕	 +
hdo 	香	*+
hdo 	怊	*+
hdp 	忉	*+
hdqf	黧	*+
hds 	惺	*+
hds 	犁	 +
hdt 	梨	*+
hduk	慨	 +
hdv 	馥	*+
hdvp	馥	 +
hdzu	啮	*+
he  	或	*+
he  	恒	*+
hec 	秽	*+
hed 	恺	*+
hede	恒	 +
hee 	忸	*+
hee 	翥	*+
heeh	稳	 +
hefl	恺	 +
heg 	稻	*+
hei 	籼	*+
heid	稻	 +
heih	稳	 +
hek 	怅	*+
hek 	怃	 +
hel 	恺	*+
heny	称	 +
hep 	惕	*+
her 	惴	*+
hetr	惴	 +
hev 	恒	*+
hez 	怔	*+
hez 	稃	*+
he, 	へ	*+
he. 	ヘ	*+
hf  	悦	*+
hfa 	煮	*+
hff 	愣	*+
hfg 	惬	*+
hfh 	愁	*+
hfj 	拜	*+
hfl 	忙	*+
hfn 	秋	*+
hfnf	鹙	*+
hfoo	怄	 +
hfx 	怄	*+
hfy 	怿	*+
hfyg	怿	 +
hg  	委	*+
hgj 	忏	*+
hgj 	秆	*+
hgl 	怃	*+
hgo 	恬	*+
hgpu	魏	 +
hgq 	种	*+
hgqd	恸	 +
hgv 	魏	*+
hgw 	逶	*+
hgx 	委	 +
hh  	稳	*+
hha 	惑	*+
hhe 	馘	*+
hhf 	愀	*+
hhmb	积	 +
hhp 	秘	*+
hhs 	愫	*+
hhu 	情	 +
hhx 	悛	*+
hhz 	悸	*+
hi  	和	*+
hi, 	ひ	*+
hi. 	ヒ	*+
hj  	手	*+
hj  	乎	*+
hja 	愤	*+
hjb 	慎	*+
hjb 	稹	*+
hjbo	穑	*+
hjcb	懒	 +
hjcs	悚	 +
hjeg	凄	 +
hjg 	凄	*+
hjj 	悴	*+
hjmb	慎	 +
hjmb	稹	 +
hjn 	快	*+
hjnz	悖	*+
hjo 	怙	*+
hjp 	秭	*+
hjqh	穗	 +
hjrb	愤	 +
hju 	忮	*+
hjv 	乎	*+
hk  	表	*+
hkh 	憾	*+
hki 	忻	*+
hkl 	忱	*+
hkl 	忾	 +
hkm 	忾	*+
hkn 	表	 +
hkz 	忾	*+
hl  	巷	*+
hlad	恹	 +
hldd	恹	 +
hldh	忆	 +
hleq	慵	*+
hlew	慷	*+
hlf 	恢	*+
hlfk	怀	 +
hlho	稿	 +
hln 	穰	*+
hlno	稿	 +
hlo 	砉	*+
hloh	懔	*+
hlok	穰	 +
hloo	稿	 +
hlos	惊	 +
hlos	懔	 +
hlp 	忭	*+
hlq 	憧	*+
hls 	惊	*+
hlxu	恼	 +
hlzo	惦	 +
hm  	看	*+
hm  	悔	*+
hmb 	责	*+
hmbd	积	 +
hmbr	恻	*+
hmc 	怜	*+
hmcs	怜	 +
hme 	租	*+
hmeb	惧	 +
hmmv	惧	 +
hmo 	看	 +
hmr 	睹	*+
hmv 	悔	*+
hmw 	悯	*+
hmx 	慢	*+
hn  	很	*+
hn  	禾	*+
hnbf	惘	*+
hnc 	恽	*+
hncp	惋	*+
hnd 	恂	*+
hnds	懈	*+
hneh	稳	 +
hneo	恫	*+
hneq	稼	*+
hnk 	秾	*+
hnmh	惚	*+
hno 	稠	*+
hno 	惆	*+
hnp 	敖	*+
hnpa	鏊	*+
hnpb	赘	*+
hnpc	螯	*+
hnpd	獒	*+
hnpf	熬	 +
hnpf	骜	*+
hnpf	鳌	 +
hnpr	聱	*+
hnpw	遨	*+
hnr 	忱	*+
hns 	称	*+
hnyo	稠	 +
hnyo	惆	 +
ho  	首	*+
ho  	者	 +
hoa 	惯	*+
hob 	积	*+
hobf	愠	 +
hoc 	悒	*+
hocl	悒	 +
hoj 	惮	*+
hok 	程	 +
hok 	愕	*+
hom 	毒	*+
homb	惯	 +
homs	纛	*+
hoo 	和	 +
hoo 	稆	*+
hooj	惮	 +
hook	愕	*+
hot 	悃	*+
hov 	者	 +
hov 	稆	*+
hox 	毒	*+
hoxb	惯	 +
hoxs	纛	*+
ho, 	ほ	*+
ho. 	ホ	*+
hp  	麦	*+
hpd 	怕	*+
hpdk	惶	*+
hpdk	慨	 +
hpdm	穆	*+
hpf 	恤	*+
hpg 	稗	*+
hpj 	秤	*+
hpj 	怦	*+
hpnd	懊	 +
hpo 	恪	*+
hpob	懊	 +
hpqg	稗	 +
hpqn	麸	*+
hpqu	愧	 +
hpx 	必	*+
hpx 	麦	 +
hpx 	皴	*+
hq  	懂	*+
hqa 	愦	*+
hqb 	秣	*+
hqbp	稷	*+
hqe 	悝	*+
hqj 	悼	*+
hqn 	慊	*+
hqo 	稿	*+
hqrp	稷	*+
hqt 	稞	*+
hr  	税	*+
hr  	悦	 +
hrd 	惜	*+
hrfm	懵	*+
hrfs	慌	 +
hrgq	懂	 +
hri 	利	*+
hrl 	秃	*+
hrp 	秀	*+
hrrr	慑	*+
hrs 	犁	*+
hrss	悱	*+
hrt 	梨	*+
hrt 	颓	 +
hrtb	颓	 +
hruu	慑	*+
hruy	悭	*+
hrv 	悦	 +
hrvu	获	 +
hrw 	透	*+
hrz 	秃	*+
hs  	慌	*+
hsa 	素	*+
hse 	性	*+
hser	恍	*+
hsn 	秩	*+
hsno	惝	*+
hso 	恼	*+
hsp 	秒	*+
hspo	恼	 +
hspx	恼	 +
hsu 	稍	*+
hsu 	悄	 +
hsv 	慌	 +
hswu	恼	 +
hsx 	恼	*+
hsxu	恼	 +
ht  	颓	*+
htd 	恸	*+
htp 	悌	*+
httz	憷	*+
hu  	情	*+
hu  	悄	*+
hua 	私	*+
hubp	悛	 +
hudm	惨	 +
hue 	青	*+
huee	静	 +
hui 	怪	 +
hum 	惨	*+
humr	靓	*+
hune	静	 +
hunz	靛	*+
huo 	怡	*+
huq 	怿	*+
hur 	懦	*+
hurp	悛	 +
hutr	懦	 +
huum	惨	 +
huv 	悄	*+
huy 	怪	 +
hu, 	ふ	*+
hu. 	フ	*+
hv  	惟	*+
hva 	愧	*+
hvb 	懒	*+
hvdp	愎	 +
hve 	稚	*+
hve 	惟	 +
hvf 	憔	*+
hvf 	怍	*+
hvff	怃	 +
hvj 	怫	*+
hvom	悔	 +
hvs 	悚	*+
hvsb	懒	 +
hvv 	惟	 +
hvx 	愎	*+
hw  	黎	*+
hwa 	导	*+
hwj 	忤	*+
hwm 	惕	*+
hwn 	道	*+
hwn 	逡	*+
hwo 	悟	*+
hwoo	穑	*+
hwu 	恼	*+
hx  	爱	*+
hxf 	恢	*+
hxiu	惰	*+
hxn 	怖	*+
hxxn	稀	*+
hy  	怪	*+
hya 	恃	*+
hybg	悻	 +
hyj 	悻	*+
hyn 	恹	*+
hyo 	秸	*+
hys 	秣	*+
hyu 	怯	*+
hz  	静	*+
hzas	秽	 +
hzdj	悼	 +
hzj 	季	*+
hzl 	忆	*+
hzo 	惦	*+
hzop	夔	*+
hzpp	夔	*+
hzz 	忆	*+
i   	这	*+
ia  	碍	*+
iaa 	讨	*+
iai 	谕	*+
iaj 	哗	*+
iak 	注	*+
iam 	论	 +
ian 	诶	*+
iao 	诟	*+
iaqn	诚	 +
iaqr	诫	 +
iaqy	诚	 +
iaur	谕	 +
iax 	议	*+
iaxi	试	 +
iay 	诚	*+
iayh	谂	*+
ib  	邮	*+
ibbe	谶	*+
ibd 	谱	*+
ibd 	谫	*+
ibe 	证	 +
ibed	谱	 +
ibed	谫	 +
ibef	谥	 +
ibef	谦	 +
ibf 	论	 +
ibh 	详	*+
ibi 	邛	*+
ibio	谘	*+
ibk 	诠	*+
ibki	议	 +
ibm 	诊	*+
ibn 	认	*+
ibod	谱	 +
ibor	说	 +
ibpd	谐	*+
ibu 	讼	*+
ibx 	议	*+
ic  	筑	*+
icdj	谭	 +
icew	谴	*+
icn 	译	*+
ics 	谏	*+
id  	误	*+
ida 	讱	*+
idah	认	 +
idem	畅	 +
idfu	谩	 +
idl 	谒	*+
idnl	谒	 +
ido 	旧	*+
ido 	诏	 +
idr 	儿	 +
idrk	夸	 +
idv 	谟	*+
idx 	功	*+
idy 	功	*+
ie  	工	*+
ieb 	谗	*+
iee 	诎	*+
iee 	诤	 +
iee 	诩	*+
ieem	谬	 +
iegu	谖	 +
iei 	讪	*+
iem 	谬	*+
ieo 	词	*+
iep 	畅	*+
ieqa	诼	*+
ieu 	诎	*+
iewu	谣	 +
iex 	谖	*+
iez 	证	 +
if  	论	*+
ifa 	诪	*+
ifbu	谞	*
ifd 	诣	*+
ife 	让	*+
iff 	谈	*+
iff 	讵	*+
iffu	燮	*+
ifk 	诓	*+
ifl 	记	*+
ifm 	谝	*+
ifo 	诟	*+
ifoo	讴	 +
ifp 	敷	*+
ifx 	讴	*+
ify 	访	*+
ify 	译	 +
ifyg	译	 +
ig  	涛	*+
igb 	谀	*+
igj 	讦	*+
igj 	谶	*+
igl 	托	*+
igl 	讬	*+
igo 	话	*+
igt 	谋	*+
igu 	叟	*+
igv 	诧	*+
igy 	谤	*+
ih  	恐	*+
ihg 	诿	*+
iho 	诸	*+
ihpf	谧	*+
ihr 	诱	*+
ihu 	请	 +
ii  	申	*+
ii  	试	 +
iie 	讧	*+
ij  	讲	*+
ij  	甫	*+
ijd 	证	 +
ije 	讲	 +
ijj 	计	*+
ijj 	讲	 +
ijj 	谇	*+
ijm 	读	 +
ijn 	诀	*+
ijnd	谳	*+
ijny	讲	 +
ijo 	诂	*+
ijqs	谏	 +
ijyb	读	 +
ijyd	读	 +
ik  	掀	*+
ika 	诉	*+
ikbl	谌	 +
iki 	欣	*+
ikk 	巧	*+
ikkd	谮	*+
ikl 	谌	*+
iklb	谌	 +
iklr	谌	 +
ikrl	谌	 +
ikv 	谌	*+
il  	该	*+
ilad	识	 +
ild 	谙	*+
ilf 	诙	*+
ilh 	该	 +
illm	谚	*+
iln 	让	*+
iln 	诔	*+
ilnf	谤	 +
ilnn	谛	*+
ilno	谪	 +
ilok	让	 +
ilos	谅	 +
iloz	谆	 +
ilpm	谚	*+
ils 	谅	*+
ilz 	谆	*+
im  	读	*+
im  	诲	*+
imb 	贡	*+
imcs	谰	 +
ime 	诅	*+
imjs	谰	 +
imn 	谰	*+
imno	谲	*+
imv 	诲	*+
imw 	谜	*+
imx 	谩	*+
in  	欠	*+
inad	谳	*+
inb 	讷	*+
inbi	谵	 +
inc 	诨	*+
incb	谗	 +
ind 	询	*+
ine 	诤	*+
ine 	诌	*+
inf 	鹅	*+
ing 	诧	*+
ing 	谄	*+
ini 	谉	*+
inii	谉
inli	谵	 +
inlp	诡	 +
inm 	谊	*+
ino 	调	*+
ino 	诇	*+
inoa	谗	 +
inp 	诡	*+
inyo	调	 +
io  	言	*+
io  	诏	*+
iob 	识	*+
ioed	误	 +
iogn	误	 +
iok 	谔	*+
iokd	误	 +
iook	谔	 +
ioot	噪	 +
iov 	诏	*+
ip  	评	*+
ipa 	讣	*+
ipf 	讹	*+
ipfj	哗	 +
ipj 	评	 +
ipx 	攻	*+
ipx 	诐	*+
ipzw	诞	 +
iq  	赞	*+
iqb 	邮	 +
iqbp	谡	*+
iqi 	申	 +
iqie	畅	 +
iqim	畅	 +
iqk 	诳	*+
iql 	电	*+
iqn 	谦	*+
iqo 	由	*+
iqrp	谡	*+
iqt 	课	 +
iqu 	谓	*+
iqu 	胄	*+
iqw 	迪	*+
iqx 	曳	*+
ir  	说	*+
ira 	巩	*+
iraa	銎	*+
irac	巩	 +
irac	蛩	 +
irah	恐	 +
iraj	巩	 +
iraz	跫	*+
irc 	谨	*+
irc 	讽	 +
irdd	谟	 +
irfs	谎	 +
irio	谘	*+
irjq	哗	 +
irl 	讥	*+
iro 	诺	*+
irp 	敢	*+
irph	憨	*+
irrj	哗	 +
irss	诽	*+
iru 	设	*+
iru 	诹	*+
irv 	诫	*+
irvu	护	 +
irx 	讽	*+
irxo	诺	 +
irz 	讥	*+
is  	谎	*+
isa 	谢	*+
isb 	诛	*+
isi 	训	*+
isnf	谠	*+
isnr	谠	*+
iso 	诰	*+
isr 	诜	*+
isrb	赞	 +
iss 	诛	*+
issa	銮	*+
issb	脔	*+
issc	蛮	 +
isse	峦	 +
issf	鸾	*+
issh	恋	 +
issh	挛	 +
issp	变	 +
issq	弯	 +
issz	孪	 +
ist 	谍	*+
isu 	诮	*+
isv 	谎	 +
it  	课	*+
ita 	项	*+
iti 	订	*+
itj 	诵	*+
itmb	项	 +
itnq	诵	 +
ito 	诃	*+
iu  	请	*+
iun 	咏	*+
iuo 	诒	*+
iuq 	译	*+
iuu 	谣	*+
iuvd	诶	 +
iuwu	谣	 +
iv  	试	*+
ive 	谁	*+
ivf 	诈	*+
ivf 	谯	*+
ivo 	谵	*+
ivom	诲	 +
ivz 	讫	*+
iv, 	ぃ	*+
iv. 	ィ	*+
iw  	诞	*+
iwb 	讥	*+
iwe 	诬	*+
iwj 	许	*+
iwj 	讳	*+
iwlm	谚	*+
iwm 	畅	*+
iwn 	汞	*+
iwn 	这	 +
iwn 	逋	*+
iwo 	语	*+
iwos	讳	*+
iwwb	讥	 +
ix  	我	*+
ix  	曳	*+
ixa 	诋	*+
ixbd	读	 +
ixe 	诋	*+
ixf 	诙	*+
ixj 	谭	*+
ixk 	夸	*+
ixo 	谪	*+
ixp 	讶	*+
ixu 	讻	*+
iy  	径	*+
iya 	诗	*+
iyd 	诸	*+
iye 	谥	*+
iyeo	词	 +
iyfb	读	 +
iyh 	志	*+
iym 	读	 +
iynr	读	 +
iyo 	诘	*+
iyp 	讶	*+
iypd	诸	 +
iyy 	诖	*+
iyzu	谞	*+
iz  	证	*+
iza 	巩	*+
iza 	銎	*+
izc 	蛩	*+
ize 	谑	*+
ized	谳	*+
izh 	恐	 +
izj 	讯	*+
izrc	巩	 +
izx 	讯	*+
izx 	巩	 +
i,  	い	*+
i,  	ぃ	*+
i,  	ゐ	*+
i.  	イ	*+
i.  	ィ	*+
i.  	ヰ	*+
j   	十	*+
ja  	祭	*+
ja  	贲	*+
jac 	捡	*+
jado	抢	 +
jae 	捡	*+
jai 	揄	*+
jai 	揿	*+
jaja	博	 +
jaja	搏	 +
jajq	捕	 +
jak 	扰	*+
jak 	拄	*+
jakp	拢	 +
jal 	拢	*+
jam 	抡	*+
jan 	挨	*+
jao 	拾	*+
jaob	捡	 +
jap 	拎	*+
jaq 	找	*+
jaq 	戟	*+
jaqb	戴	 +
jaqc	载	 +
jaqh	撼	 +
jaqk	裁	 +
jaqo	哉	 +
jaqt	栽	 +
jaqv	截	 +
jase	捡	 +
jat 	拎	*+
jaur	揄	 +
jav 	搏	*+
jav 	贲	 +
jaw 	挝	*+
jax 	拔	*+
jaxf	拢	 +
jaxi	拭	*+
jaxu	拔	 +
jaxu	拨	 +
jaxx	拔	 +
jayh	捻	 +
jb  	戴	*+
jb  	损	 +
jba 	真	*+
jba 	枣	*+
jba 	扒	 +
jbbb	赍	*+
jbby	挫	 +
jbd 	扮	*+
jbd 	斡	*+
jbea	撙	*+
jbeb	掷	 +
jbee	翰	*+
jbef	搛	*+
jbek	丧	 +
jbeo	啬	*+
jbeu	搠	*+
jbf 	抡	*+
jbg 	干	 +
jbgb	掷	 +
jbgo	舍	 +
jbhi	搓	*+
jbj 	拌	*+
jbk 	拼	*+
jbk 	丧	 +
jbk 	拴	*+
jbki	搓	*+
jbl 	批	*+
jbl 	擒	*+
jblu	擒	*+
jbn 	扒	*+
jbnl	卷	 +
jbnp	卷	 +
jbnv	扒	 +
jbo 	舍	*+
jbp 	抢	*+
jbpd	揩	*+
jbqj	掸	 +
jbs 	拦	*+
jbt 	颠	*+
jbt 	干	 +
jbtb	颠	 +
jbv 	损	 +
jbv 	摈	*+
jbwu	擒	*+
jbx 	撇	*+
jbyo	舍	 +
jc  	载	*+
jcbk	摒	*+
jcdj	掸	 +
jce 	事	*+
jcee	掘	*+
jceq	掾	*+
jceu	掘	*+
jcie	事	 +
jcjo	据	 +
jck 	衷	*+
jcl 	把	*+
jcn 	择	*+
jcnc	蠹	*+
jcnk	囊	 +
jcnt	橐	*+
jcol	擗	*+
jcp 	握	*+
jcrk	搌	*+
jcs 	束	*+
jcs 	拣	 +
jcsb	赖	 +
jcsd	敕	 +
jcsp	敕	 +
jcsr	剌	 +
jcsw	速	 +
jcsz	整	 +
jcu 	叓	*+
jcua	抟	 +
jcv 	换	 +
jcx 	吏	*+
jd  	换	*+
jdb 	协	*+
jdb 	邓	 +
jdbs	撩	 +
jdcr	挽	 +
jddd	协	 +
jde 	担	*+
jde 	登	 +
jdem	扬	 +
jdez	提	 +
jdg 	捍	*+
jdi 	揣	*+
jdil	掩	 +
jdj 	抖	*+
jdjd	斡	*+
jdje	翰	*+
jdjg	干	 +
jdjq	戟	*+
jdjs	韩	 +
jdjt	干	 +
jdju	朝	 +
jdjw	韩	 +
jdjz	乾	 +
jdl 	揭	*+
jdnl	揭	 +
jdo 	招	*+
jdql	掩	 +
jdr 	凳	*+
jdrk	挎	 +
jdrs	捺	*+
jdru	撮	*+
jdto	掎	*+
jdv 	摸	*+
jdw 	挞	*+
jdy 	捏	*+
je  	直	*+
jea 	捋	*+
jeaf	捻	 +
jeb 	挪	*+
jeb 	搀	*+
jed 	癸	*+
jedf	掭	*+
jedh	掭	*+
jee 	扫	*+
jee 	扭	 +
jee 	拙	 +
jee 	挣	 +
jeed	摺	*+
jeev	扭	 +
jeev	挣	 +
jeev	擢	*+
jefe	挜	*+
jeg 	妻	*+
jegu	援	 +
jei 	抓	*+
jej 	扫	*+
jek 	抚	*+
jel 	挽	*+
jen 	抓	*+
jenn	扫	 +
jenu	授	 +
jeo 	捃	*+
jep 	扬	*+
jer 	揣	*+
jet 	采	*+
jetr	揣	 +
jeu 	拙	*+
jev 	摧	*+
jevm	携	 +
jevo	携	 +
jevr	携	 +
jevt	携	 +
jevu	携	 +
jewu	摇	 +
jex 	援	*+
jf  	摆	*+
jfa 	然	*+
jfad	捩	*+
jfb 	扑	*+
jfd 	指	*+
jfdg	揠	*+
jfed	扑	 +
jfek	擐	*+
jff 	拒	*+
jffd	捞	*+
jffu	背	 +
jfk 	振	*+
jfl 	匙	*+
jflb	撰	*+
jfn 	揍	*+
jfnd	揍	 +
jfnn	揍	 +
jfnq	捧	 +
jfoo	抠	*+
jfp 	护	*+
jfp 	抑	 +
jfu 	掮	*+
jfu 	摆	 +
jfuf	摆	 +
jfvz	拟	 +
jfx 	拨	*+
jfx 	抠	*+
jfy 	择	*+
jfyg	择	 +
jfyu	摆	 +
jg  	据	*+
jg  	掐	*+
jgb 	掷	*+
jge 	捶	*+
jgg 	插	*+
jgi 	捏	*+
jgi 	挢	*+
jgiu	搜	 +
jgj 	扦	*+
jgjy	捶	 +
jgl 	托	*+
jgl 	抚	 +
jgn 	挟	*+
jgn 	癸	 +
jgnf	掭	*+
jgnh	掭	*+
jgno	挢	*+
jgnr	挢	*+
jgo 	括	*+
jgo 	挢	*+
jgry	捶	 +
jgu 	搜	*+
jgv 	掐	*+
jgx 	妻	*+
jgy 	捏	*+
jh  	惠	*+
jh  	撑	*+
jhf 	揪	*+
jhv 	撑	*+
ji  	控	*+
ji  	掀	 +
jia 	博	*+
jia 	搏	 +
jie 	扛	*+
jigu	搜	 +
jii 	抻	*+
jij 	捕	*+
jiq 	抽	*+
jiqi	抻	 +
jiqx	拽	 +
jirp	撖	*+
jiv 	掀	 +
jix 	拽	*+
ji, 	じ	*+
ji, 	ぢ	*+
ji. 	ジ	*+
ji. 	ヂ	*+
jj  	井	*+
jjbg	擀	*+
jjck	攮	*+
jjdg	擀	*+
jje 	构	*+
jjed	揆	 +
jjez	捷	 +
jjf 	捻	*+
jjgn	揆	 +
jjj 	卒	*+
jjj 	矗	*+
jjn 	提	 +
jjn 	抉	*+
jjn 	棘	*+
jjn 	枣	*+
jjny	构	 +
jjqa	抟	 +
jjqs	拣	 +
jjqu	拨	 +
jju 	技	*+
jjv 	提	 +
jjz 	捷	*+
jk  	裁	*+
jka 	拆	*+
jka 	执	 +
jkac	蛰	 +
jkad	势	 +
jkaf	鸷	*+
jkah	挚	 +
jkap	拢	 +
jkas	絷	 +
jkay	垫	 +
jkbk	撕	*+
jkc 	蜇	*+
jkd 	抛	*+
jkdf	热	 +
jkh 	撼	*+
jki 	折	*+
jki 	誓	 +
jki 	掀	 +
jkn 	揆	*+
jko 	哲	*+
jkoz	踅	*+
jkt 	攒	*+
jkv 	丧	*+
jkw 	逝	*+
jkw 	挺	 +
jkzb	贽	*+
jl  	扩	*+
jl  	直	 +
jla 	撩	*+
jlbi	撅	*+
jlbj	摔	 +
jld 	揞	*+
jle 	拉	*+
jleo	搪	*+
jlg 	接	*+
jlho	搞	 +
jlj 	摔	*+
jlk 	扩	 +
jll 	扎	*+
jln 	攘	*+
jlno	摘	 +
jlno	搞	 +
jlo 	拓	*+
jlo 	掊	*+
jloe	擅	*+
jlok	攘	 +
jlom	擅	*+
jloo	搞	 +
jlos	掠	 +
jlp 	扩	 +
jlp 	扼	 +
jlpu	掖	 +
jlq 	撞	*+
jlr 	抗	*+
jlrb	扩	 +
jlrf	摭	*+
jls 	掠	*+
jlt 	操	*+
jlu 	扳	*+
jlu 	扩	 +
jlul	拢	 +
jlwj	摔	 +
jlwq	搐	*+
jlwv	拥	 +
jlx 	掖	*+
jlyy	捱	*+
jlzo	掂	*+
jlzr	搋	*+
jm  	损	*+
jma 	卖	*+
jmbg	撄	 +
jmcs	拦	 +
jme 	直	 +
jmeb	真	 +
jmeb	颠	 +
jmee	矗	*+
jmet	颠	 +
jmg 	搂	*+
jmgp	擞	*+
jmi 	扪	*+
jmjs	拦	 +
jml 	直	 +
jmlb	真	 +
jmlb	颠	 +
jmll	矗	*+
jmlt	颠	 +
jmmm	撬	*+
jmmr	觌	*+
jmmu	攫	*+
jmn 	拦	*+
jmpo	搁	*+
jmq 	播	*+
jmr 	觏	*+
jmt 	揉	*+
jmy 	扪	*+
jn  	是	*+
jnbb	枣	*+
jnbc	撺	*+
jnbd	献	 +
jnbe	榨	*+
jnbf	榨	*+
jnbf	捻	 +
jnbg	南	 +
jnbi	控	 +
jnbi	担	 +
jnbs	撺	*+
jnbt	探	 +
jnbz	挖	 +
jnc 	挥	*+
jnc 	换	 +
jncb	搀	*+
jncb	摈	 +
jncr	挽	 +
jne 	挣	*+
jne 	捣	*+
jne 	揎	*+
jnee	揎	*+
jnfb	换	 +
jng 	按	*+
jng 	掐	 +
jnht	拧	 +
jni 	掏	*+
jnj 	擦	*+
jnjs	擦	 +
jnkb	摈	*+
jnl 	抱	*+
jnli	担	 +
jnm 	掬	*+
jnmb	赖	 +
jnn 	探	*+
jnnd	换	 +
jno 	拘	*+
jnoa	搀	*+
jnol	抱	 +
jnpb	摈	*+
jnq 	拥	*+
jnrc	撺	*+
jnre	榨	*+
jnrf	榨	*+
jnrf	捻	 +
jnri	控	 +
jnrs	撺	*+
jnrt	探	 +
jnrz	挖	 +
jns 	索	*+
jnsb	枣	*+
jnsb	摈	 +
jnsr	刺	 +
jnss	棘	*+
jnss	枣	 +
jnt 	拧	*+
jnwu	掏	 +
jnyr	觏	 +
jnyw	遘	*+
jnz 	孛	*+
jnzd	勃	*+
jnzf	鹁	*+
jo  	哉	*+
jo  	据	 +
joa 	捡	*+
joa 	掼	*+
joae	掴	 +
joc 	挹	*+
jocl	挹	 +
jod 	拐	*+
jodh	摁	*+
jodr	捌	*+
joh 	掴	*+
joj 	掸	*+
joka	掴	 +
jol 	辜	*+
jolb	撰	*+
jom 	拇	*+
jomb	损	 +
jomb	掼	 +
jon 	拐	*+
jon 	擐	*+
jonf	鸪	*+
jonr	捌	*+
joo 	古	*+
joo 	扣	*+
joo 	嘏	*+
jooj	掸	 +
jook	丧	 +
joot	操	 +
joou	嘏	*+
jop 	故	 +
jor 	克	*+
jor 	揖	*+
jorr	兢	*+
jot 	捆	*+
jou 	捐	*+
jou 	胡	 +
jouf	鹕	*+
jov 	据	 +
jox 	抿	*+
joxb	掼	*+
joz 	捉	*+
jp  	抑	*+
jp  	扼	*+
jpa 	扑	*+
jpa 	拊	*+
jpd 	拍	*+
jpdf	掭	*+
jpdh	掭	*+
jpdo	挢	*+
jpdr	挢	*+
jpg 	捭	*+
jpj 	抨	*+
jpj 	擗	*+
jpl 	卷	 +
jpmr	擤	*+
jpp 	才	 +
jpqg	捭	 +
jpqr	擤	*+
jpu 	报	 +
jpv 	扼	*+
jpx 	披	*+
jq  	捧	*+
jqa 	抟	*+
jqac	撵	*+
jqb 	夷	 +
jqb 	抹	 +
jqbb	搦	*+
jqer	挠	 +
jqh 	惠	 +
jqi 	押	*+
jqj 	掉	*+
jqmm	搦	*+
jqn 	扶	*+
jqn 	搛	*+
jqnc	撵	*+
jqo 	搞	*+
jqow	挝	 +
jqpo	撂	*+
jqru	发	 +
jqs 	柬	*+
jqs 	东	 +
jqs 	摞	*+
jqu 	叀	*+
jqua	专	 +
jquh	惠	 +
jqx 	拽	*+
jr  	摄	*+
jra 	挑	*+
jrao	搭	 +
jrb 	拱	*+
jrb 	揶	*+
jrbb	挑	 +
jrbt	搽	*+
jrcv	摊	 +
jrd 	措	*+
jrdd	摸	 +
jre 	世	 +
jrfr	揽	 +
jri 	刺	*+
jrj 	卉	*+
jrk 	拷	*+
jrmb	贲	 +
jrmr	揽	 +
jrnd	捞	*+
jro 	搭	*+
jrp 	扔	*+
jrq 	描	*+
jrrr	摄	 +
jrs 	祭	 +
jrss	排	 +
jru 	投	*+
jrup	撒	 +
jruu	摄	 +
jrvr	揽	 +
jrx 	撒	*+
js  	排	*+
js  	拣	*+
jsc 	拶	*+
jse 	挡	*+
jsg 	撄	*+
jsnh	撑	 +
jsnp	撇	 +
jsnq	挡	 +
jsnr	搅	*+
jsnx	撑	 +
jsny	撑	 +
jso 	挡	*+
jsp 	抄	*+
jsrb	攒	 +
jst 	揲	*+
jsu 	捎	*+
jt  	栽	*+
jta 	题	 +
jtde	揸	 +
jtdp	扰	 +
jti 	打	*+
jtj 	捅	*+
jtm 	揸	*+
jtmb	题	 +
jtmp	扰	 +
jtnq	捅	 +
jtrp	撖	*+
jtup	撤	 +
jtv 	杂	*+
jtx 	撤	*+
ju  	报	*+
jua 	拟	*+
jua 	捋	 +
juac	搔	*+
juaf	捻	 +
jub 	拟	*+
jubc	搔	*+
judm	掺	 +
jue 	朝	*+
jued	撸	*+
juee	翅	*+
jufd	撸	*+
jui 	抒	*+
jum 	掺	*+
juo 	抬	*+
juq 	择	*+
juq 	擂	*+
jur 	拚	*+
juu 	摇	*+
juum	掺	 +
juut	搡	*+
juuu	掇	*+
juv 	摊	*+
juv 	攉	*+
juvd	挨	 +
juwu	摇	 +
jux 	支	*+
jv  	截	*+
jva 	拖	*+
jve 	推	*+
jvff	抚	 +
jvj 	拂	*+
jvl 	揽	*+
jvm 	携	*+
jvn 	扑	*+
jvnk	攮	*+
jvo 	担	*+
jvo 	掎	*+
jvr 	携	*+
jvu 	携	*+
jvz 	乾	*+
jw  	挺	*+
jwd 	拗	*+
jwe 	拯	*+
jwh 	挤	*+
jwj 	韩	*+
jwj 	韪	*+
jwm 	扬	*+
jwn 	进	*+
jwn 	遘	*+
jwo 	捂	*+
jwos	韩	 +
jwos	韪	 +
jwr 	挤	*+
jwx 	擦	*+
jx  	故	*+
jxa 	抵	*+
jxa 	抟	 +
jxe 	抵	*+
jxj 	掸	*+
jxk 	挎	*+
jxl 	掩	*+
jxo 	摘	*+
jxxb	爽	*+
jy  	挫	*+
jya 	持	*+
jybd	卖	 +
jybr	觌	*+
jybw	挞	 +
jyo 	拮	*+
jyob	撷	*+
jyot	撷	*+
jypk	拷	 +
jyr 	挠	*+
jys 	抹	*+
jyw 	挞	*+
jyx 	扰	*+
jyy 	挂	*+
jyyp	挂	 +
jyyr	挠	 +
jz  	提	*+
jz  	挖	*+
jza 	执	*+
jzc 	蛰	*+
jzd 	势	*+
jzd 	掳	*+
jzdj	掉	 +
jze 	扯	*+
jzeq	据	 +
jzez	捷	 +
jzf 	热	*+
jzh 	挚	*+
jzh 	摅	*+
jzmb	贽	*+
jzms	攥	*+
jzn 	据	 +
jznf	鸷	*+
jzo 	拈	*+
jzo 	掂	*+
jzqd	掳	*+
jzqh	摅	*+
jzru	搬	 +
jzs 	絷	*+
jzu 	搬	*+
jzv 	挖	*+
jzx 	执	*+
jzy 	垫	*+
k   	九	*+
ka  	黄	*+
kaa 	玉	*+
kaa 	斥	 +
kaa 	丸	 +
kaa 	々	 +
kab 	琅	*+
kadb	琅	 +
kadk	琅	 +
kai 	瑜	*+
kajw	球	 +
kakp	珑	 +
kal 	珑	*+
kan 	琅	*+
kap 	玲	*+
kaq 	戡	*+
kat 	玲	*+
kaur	瑜	 +
kav 	斥	*+
kav.	ヵ	*+
kax 	斥	*+
kaxf	珑	 +
ka, 	か	*+
ka. 	カ	*+
kb  	环	*+
kb  	邢	*+
kba 	其	*+
kba 	环	 +
kbbu	函	 +
kbd 	氛	*+
kbd 	玢	*+
kbh 	氧	*+
kbi 	欺	*+
kbi 	邢	 +
kbk 	斯	*+
kbl 	甚	 +
kbld	勘	 +
kbld	斟	 +
kblq	戡	 +
kbm 	珍	*+
kbp 	玱	*+
kbr 	尬	*+
kbs 	綦	*+
kbtm	馗	 +
kbu 	期	 +
kbv 	邢	*+
kby 	基	 +
kc  	冠	*+
kcew	氯	 +
kcjo	琚	*+
kcw 	琏	*+
kd  	丘	*+
kdb 	琨	*+
kdf 	氲	*+
kdi 	瑞	*+
kdj 	斟	*+
kdm 	瑁	*+
kdo 	旭	*+
kdo 	珈	*+
kdo 	旮	*+
kdto	琦	 +
kdx 	勘	*+
kdy 	勘	*+
ke  	王	*+
ke  	壬	*+
kea 	乓	*+
keb 	邱	*+
keb 	兵	 +
kee 	与	 +
kee 	丘	 +
kee 	岳	 +
kefe	氩	 +
kegu	瑗	 +
kei 	岳	*+
kei 	氙	*+
kei 	欤	 +
kenm	玚
kenp	瑷	 +
kenu	瑷	 +
kep 	乒	*+
keqa	琢	*+
ker 	瑞	*+
kesi	氢	 +
ketr	瑞	 +
kev 	壬	*+
kev 	璀	*+
kev.	ヶ	*+
kew 	氯	*+
kewu	瑶	 +
kex 	瑗	*+
ke, 	け	*+
ke. 	ケ	*+
kf  	与	*+
kfb 	璞	*+
kfe 	盏	*+
kfed	璞	 +
kfek	环	 +
kff 	氮	*+
kff 	琰	*+
kfu 	瑚	*+
kfvz	璇	 +
kg  	授	*+
kh  	惩	*+
kha 	感	 +
kho 	馗	*+
khu 	氰	*+
khx 	瑷	*+
ki  	斤	*+
kin 	欣	*+
ki, 	き	*+
ki. 	キ	*+
kj  	开	*+
kjor	氪	*+
kjou	瑚	 +
kjw 	琎	*+
kk  	班	*+
kk  	丂	*+
kka 	璜	*+
kka 	珏	 +
kkay	琴	*+
kkb 	琵	*+
kkb 	琪	*+
kkbl	琵	 +
kkc 	琶	*+
kkcl	琶	 +
kkdc	蚕	 +
kke 	珏	*+
kke 	玙	*+
kkhp	瑟	*+
kkmb	质	 +
kkt 	瓒	*+
kk, 	っ	*+
kk. 	ッ	*+
kl  	甚	*+
kl  	尢	*+
kl  	兂	*+
kla 	璃	*+
klb 	甚	 +
klbd	勘	 +
klbd	斟	 +
klbq	戡	 +
kldj	璋	*+
kleo	瑭	*+
klh 	氦	*+
kln 	镶	*+
klo 	璐	*+
klok	镶	 +
klos	琼	 +
klr 	甚	 +
klrd	勘	 +
klrd	斟	 +
klrq	戡	 +
kls 	琼	*+
klul	珑	 +
klxu	璃	 +
klxu	瑙	 +
km  	形	*+
kmb 	质	*+
kmbg	璎	 +
kmf 	玛	*+
kmii	珩	*+
kmit	珩	*+
kmj 	珊	*+
kmn 	气	 +
kmo 	盾	*+
kmp 	形	 +
kmr 	现	*+
kmw 	遁	*+
kn  	长	*+
kna 	球	*+
kna 	尥	*+
knbt	琛	*+
knc 	珲	*+
kncp	琬	*+
knf 	鸩	*+
knf 	鸠	*+
knfp	琼	 +
kng 	氨	*+
knn 	玖	*+
knn 	琛	*+
knne	珊	 +
knnp	琼	 +
knop	琼	 +
knr 	珊	*+
knrs	琮	 +
knrt	琛	*+
kns 	琮	*+
ko  	咸	*+
ko  	碧	*+
kobf	氲	 +
kod 	氤	*+
koe 	氩	*+
kofu	瑕	 +
kon 	环	 +
kooo	噩	 +
koq 	琉	*+
koue	亟	*+
kox 	瑕	*+
kox 	珉	*+
kozo	璐	 +
ko, 	こ	*+
ko. 	コ	*+
kp  	玫	*+
kpa 	璁	*+
kpax	玳	*+
kpb 	氡	*+
kpd 	珀	*+
kpdo	碧	 +
kpo 	珞	*+
kpoh	璁	 +
kpp 	氕	*+
kpqu	瑰	 +
kpx 	玻	*+
kpx 	玫	 +
kq  	理	*+
kqe 	理	 +
kqv 	戡	*+
kr  	弄	*+
kra 	珧	*+
krb 	珙	*+
krbb	珧	 +
krc 	瑛	*+
krc 	瑾	*+
kreb	璜	 +
kren	佩	 +
krf 	尴	*+
kri 	刑	*+
kri 	氘	*+
krj 	弄	 +
krj 	珥	*+
krk 	班	 +
krl 	甚	 +
krl 	玑	 +
krld	勘	 +
krld	斟	 +
krlq	戡	 +
krp 	氖	*+
krr 	玩	*+
krtn	佩	 +
krvf	尴	 +
kry 	型	*+
krz 	玑	*+
ks  	贴	*+
ksb 	珠	*+
kse 	珰	*+
ksg 	璎	*+
ksi 	氢	*+
ksi 	氚	*+
ksmb	琐	*+
kso 	瑙	*+
kspo	瑙	 +
kspx	瑙	 +
ksrb	瓒	 +
kss 	珠	*+
kswu	瑙	 +
ksx 	瑙	*+
kt  	赏	*+
kta 	顼	*+
kta 	颀	*+
kti 	玎	*+
ktmb	顼	 +
ktmb	颀	 +
ktn 	杂	*+
kto 	珂	*+
ktp 	乒	*+
kts 	琉	*+
ktt 	琳	*+
ktu 	岳	*+
ku  	期	*+
kua 	丢	*+
kui 	氢	*+
kuu 	瑶	*+
kuwu	瑶	 +
kuy 	氢	*+
ku, 	く	*+
ku. 	ク	*+
kv  	兵	*+
kva 	瑰	*+
kvj 	氟	*+
kvm 	玚	*
kvn 	璞	*+
kvo 	琦	*+
kw  	廷	*+
kwb 	玑	*+
kwj 	玮	*+
kwk 	斑	*+
kwm 	玚	*+
kwn 	近	*+
kwn 	廷	 +
kwos	玮	 +
kwt 	颋	*
kwtb	颋	 +
kwu 	瑙	*+
kwuu	璃	 +
kwwb	玑	 +
kwx 	玟	*+
kwyu	珐	 +
kx  	养	*+
kx  	戋	*+
kxb 	琊	*+
kxk 	班	 +
kxx 	气	 +
ky  	基	*+
kyb 	琊	*+
kyk 	班	 +
kyu 	珐	*+
kyym	玚
kz  	气	*+
kz  	璇	*+
kzcm	璨	*+
kzeq	璩	 +
kzn 	璩	*+
kzo 	玷	*+
kzr 	琥	*+
kzv 	璇	*+
l   	六	*+
l   	广	*+
la  	丽	*+
la  	离	 +
lab 	廊	*+
lad 	厌	*+
ladb	廊	 +
ladf	黡	*+
ladh	靥	*+
ladi	厣	 +
lado	靥	*+
ladv	魇	*+
ladx	餍	 +
lakp	庞	 +
lal 	庞	*+
lao 	耠	*+
laxf	庞	 +
laxu	废	 +
la, 	ら	*+
la, 	ぁ	*
la. 	ラ	*+
la. 	ァ	*
lb  	病	*+
lb  	腐	*+
lba 	飞	*+
lba 	鏖	*+
lba 	愈	 +
lbah	愈	 +
lbak	疣	*+
lbak	疰	*+
lbak	麈	*+
lbao	疮	*+
lbar	愈	 +
lbbh	瘾	*+
lbbh	痒	 +
lbbi	瘥	*+
lbbj	瘅	*+
lbbk	痊	*+
lbbm	疹	*+
lbbo	痞	*+
lbbp	疮	*+
lbbr	疥	*+
lbbs	癃	*+
lbbu	瘠	*+
lbbx	痒	*+
lbby	座	 +
lbby	痤	*+
lbc 	疤	*+
lbcg	癖	*+
lbcl	疤	 +
lbcl	癖	 +
lbcs	瘭	*+
lbcu	癜	*+
lbcu	瘘	 +
lbd 	痘	*+
lbdb	瘸	*+
lbde	疸	*+
lbdf	瘟	*+
lbdk	痕	*+
lbdm	疡	*+
lbdo	痂	*+
lbdq	瘤	*+
lbds	疗	 +
lbe 	疟	*+
lbe 	疝	*+
lbe 	痍	*+
lbe 	疡	*+
lbe 	病	 +
lbea	瘃	*+
lbeb	病	 +
lbee	痖	*+
lbef	廉	 +
lbei	厥	*+
lbei	痉	 +
lbem	瘳	*+
lbeq	瘃	*+
lber	劂	*+
lbez	症	 +
lbfb	瘀	*+
lbfd	痨	*+
lbff	痰	*+
lbfh	瘛	*+
lbfu	瘠	*+
lbfz	痴	*+
lbg 	疳	*+
lbgb	瘐	*+
lbgu	瘦	*+
lbgy	瘗	*+
lbh 	庠	*+
lbh 	麇	*+
lbh 	酸	 +
lbhg	痿	*+
lbhh	瘛	*+
lbhr	痢	*+
lbi 	邝	*+
lbi 	郦	*+
lbiu	瘦	*+
lbj 	瘵	*+
lbjb	癫	*+
lbjb	癞	 +
lbjb	痍	 +
lbjj	瘁	*+
lbjr	瘌	*+
lbjs	瘵	 +
lbjt	癫	*+
lbk 	癀	*+
lbkb	麒	*+
lbkk	癍	*+
lbl 	鹿	*+
lbl 	庇	*+
lbl 	疗	 +
lbld	疬	*+
lblh	癔	*+
lblj	瘴	*+
lblw	痃	*+
lbm 	疽	*+
lbm 	麋	*+
lbmc	麟	*+
lbmg	瘘	*+
lbmg	瘿	 +
lbmp	症	 +
lbms	麟	*+
lbmt	痫	*+
lbmv	癯	*+
lbn 	仄	*+
lbn 	疱	 +
lbnc	痪	*+
lbnd	痪	*+
lbnl	疱	 +
lbnn	疚	*+
lbnq	痈	*+
lbo 	耜	*+
lbo 	痖	*+
lbo 	瘅	*+
lbo 	瘕	*+
lboe	癌	*+
lbof	瘟	*+
lboj	瘅	*+
lboo	痼	*+
lboq	瘤	*+
lbou	瘕	*+
lbp 	疲	*+
lbp 	癖	*+
lbp 	疖	*+
lbpb	疼	*+
lbpd	瘊	*+
lbpf	瘪	*+
lbpg	痹	*+
lbpm	瘪	*+
lbqr	痹	*+
lbqs	瘰	*+
lbr 	麂	*+
lbrb	癀	 +
lbrc	疯	 +
lbrd	瘼	 +
lbrd	痨	 +
lbro	瘩	*+
lbrs	痱	*+
lbru	疫	*+
lbru	疠	 +
lbrv	瘫	*+
lbrx	疯	 +
lbsa	麝	*+
lbsg	瘿	*+
lbsi	痉	*+
lbsj	瘅	*+
lbt 	痛	 +
lbt 	疔	*+
lbtb	病	 +
lbto	疴	*+
lbtq	痛	 +
lbtt	麻	 +
lbub	瘀	*+
lbuc	瘙	*+
lbuh	癣	*+
lbui	痉	*+
lbup	酸	 +
lbuv	瘫	*+
lbuy	痉	*+
lbv 	腐	*+
lbv 	疠	*+
lbvb	癞	*+
lbvd	疾	 +
lbvf	痄	*+
lbvo	痴	*+
lbvr	瘌	*+
lbvz	疙	*+
lbw 	疗	*+
lbwj	率	 +
lbwm	疡	*+
lbwo	痦	*+
lbws	痧	*+
lbwu	瘠	*+
lby 	尘	*+
lbya	痔	*+
lbyh	痣	*+
lbze	疟	 +
lbzf	疵	*+
lbzu	瘢	*+
lc  	础	*+
lca 	麦	 +
lca 	虱	 +
lcj 	库	*+
lcj 	厍	*+
lck 	衷	*+
lcl 	耙	*+
lcnm	麴	*+
lcqn	麸	*+
lcth	面	 +
lcto	面	 +
lcty	面	 +
ld  	疾	*+
lda 	厨	*+
lddo	韶	*+
ldh 	意	*+
ldi 	端	*+
ldi 	歆	*+
ldil	庵	 +
ldj 	章	*+
ldjb	赣	*+
ldjb	鄣	*+
ldjh	戆	*+
ldjm	彰	 +
ldk 	衰	*+
ldl 	办	*+
ldl 	竭	*+
ldl 	厩	*+
ldn 	庆	*+
ldnb	韵	*+
ldnl	竭	*+
ldnr	韵	*+
ldo 	音	*+
ldob	韵	*+
ldql	庵	 +
ldr 	竟	*+
ldud	厌	 +
lduh	靥	*+
ldui	厣	 +
lduk	厩	*+
lduo	靥	*+
lduu	厩	*+
lduu	魇	 +
lduv	魇	*+
ldux	餍	 +
lduy	压	 +
ldv 	瘼	*+
ldx 	历	*+
ldy 	历	*+
ldz 	厚	*+
le  	立	*+
leb 	庚	*+
lebb	赓	*+
lebf	鹒	*+
lee 	翊	*+
leem	廖	 +
lek 	庑	*+
lem 	廖	*+
len 	庚	*+
len 	厉	 +
lenb	赓	*+
lend	励	 +
lenf	鹒	*
lenq	庸	*+
leo 	唐	*+
leok	褒	*+
ler 	端	*+
letr	端	 +
lev 	碰	*+
lew 	康	*+
le, 	れ	*+
le, 	ぇ	*
le. 	レ	*+
le. 	ェ	*
lf  	熟	*+
lf  	码	 +
lfa 	亦	*+
lfa 	銮	*+
lfb 	亪	*
lfc 	蛮	*+
lfd 	奕	*+
lfe 	峦	*+
lff 	盔	*+
lffd	耢	*+
lfg 	娈	*+
lfh 	恋	*+
lfh 	挛	*+
lfka	耨	*+
lfl 	庀	*+
lfn 	灰	*+
lfnb	脔	*+
lfnf	鸾	*+
lfp 	庐	*+
lfp 	变	 +
lfq 	弯	*+
lfr 	弈	*+
lfr 	兏	*+
lft 	栾	*+
lft 	庼	*
lftb	庼	*+
lfu 	变	*+
lfv 	码	 +
lfw 	迹	*+
lfx 	废	*+
lfy 	亪	*+
lfz 	孪	*+
lg  	碑	*+
lg  	亳	*+
lga 	瓤	*+
lgb 	庾	*+
lgk 	裒	*+
lgl 	瓣	*+
lgl 	庑	 +
lgn 	瓤	*+
lgv 	亳	*+
lgx 	妾	*+
lgy 	耪	*+
lh  	顾	*+
lh  	摩	*+
lha 	亥	*+
lhd 	劾	*+
lhhd	历	 +
lhhz	历	 +
lhn 	亥	*+
lhng	亳	 +
lhnm	毫	 +
lhno	高	 +
lhnp	廒	*+
lhnq	豪	 +
lhnr	亮	 +
lhnt	亭	 +
lhnu	膏	 +
lhnu	敲	 +
lhr 	刻	*+
lhsk	就	 +
lht 	颏	*+
lhtb	颏	 +
lhu 	靖	*+
lhv 	摩	*+
lhw 	亨	*+
lhx 	竣	*+
lhz 	享	*+
lhzb	郭	 +
lhzf	熟	 +
lhzf	鹑	 +
lhzp	敦	 +
lhzy	塾	*+
lhzz	孰	 +
li  	新	*+
lil 	辩	*+
liq 	庙	*+
li, 	り	*+
li, 	ぃ	*
li. 	リ	*+
li. 	ィ	*
lj  	辛	*+
lj  	耕	*+
ljcs	辣	 +
ljcs	竦	 +
ljdu	庙	 +
lje 	耩	*+
ljj 	率	*+
ljj 	耕	 +
ljny	耩	 +
ljqu	废	 +
lju 	庙	*+
lju 	庋	*+
ljv 	耕	*+
ljzk	亵	*+
ljzx	亵	*+
lk  	就	*+
lk  	哀	*+
lka 	广	 +
lka.	ヵ	*
lkb 	邝	*+
lkbk	厮	*+
lke.	ヶ	*
lkl 	庑	*+
lkn 	衣	*+
lkn 	哀	 +
lkno	裔	*+
lkw 	庭	*+
ll  	产	*+
ll  	乚	*+
llb 	丽	 +
llbb	郦	*+
llbw	逦	*+
llhb	廓	*+
lll 	乵	*+
llm 	彦	*+
llmb	颜	 +
llmt	颜	 +
llnf	耪	 +
llob	廓	*+
lloh	廪	*+
llos	廪	*+
llp 	产	 +
llr 	铲	*+
llto	耱	*+
llul	庞	 +
llzb	廓	*+
lm  	彰	*+
lm  	毫	*+
lmb 	赉	*+
lmbr	厕	*+
lmg 	耧	*+
lmk 	断	 +
lmk 	袤	*+
lml 	耗	*+
lmv 	毫	*+
ln  	来	*+
ln  	襄	*+
ln  	耒	*+
lnbo	商	 +
lnds	廨	*+
lneq	豪	 +
lnf 	旁	 +
lnf 	鹭	*+
lnf 	鹂	*+
lnf 	鹩	*+
lng 	亳	*+
lni 	市	 +
lnj 	市	 +
lnjp	敌	 +
lnjw	适	 +
lnl 	庖	*+
lnm 	毫	*+
lnn 	帝	*+
lnno	啻	*+
lno 	高	 +
lnol	庖	 +
lnou	膏	 +
lnou	敲	 +
lnq 	豪	*+
lnr 	亮	*+
lnro	商	 +
lnt 	亭	*+
lo  	路	*+
lo  	碉	*+
loa 	硷	*+
loab	碱	*+
loae	硷	 +
loao	碱	*+
lob 	部	*+
lob 	砒	*+
lob 	碰	 +
lobe	碰	 +
lobi	磋	*+
lobi	砼	*+
lobo	碰	 +
lobw	磁	 +
lobz	砭	*+
loc 	矽	*+
loc 	硒	*+
loc 	磕	*+
loc 	砗	*+
loca	砖	 +
locd	砌	*+
lock	碾	*+
loct	磔	*+
locw	碌	*+
lod 	碣	*+
loda	碍	 +
lodl	碣	 +
lodm	砀	 +
loe 	砀	*+
loe 	砘	*+
loee	础	 +
loee	礓	*+
loef	碳	*+
loel	硙	*+
loer	硚	*
loeu	础	 +
loew	碌	*+
lofb	碘	*+
lofm	碥	*+
lofn	砸	*+
lofn	砺	 +
lofs	砾	*+
lofz	碍	 +
log 	磅	*+
log 	矸	*+
log 	硖	*+
logr	硚	*
lohb	碛	*+
lohm	碡	*+
lohx	碡	*+
loi 	砍	*+
loi 	砷	*+
loi 	硪	*+
loii	砷	*+
loja	砖	 +
lojd	磴	*+
lojj	碎	*+
lok 	研	*+
lok 	哀	 +
lok 	磺	*+
lok 	碱	*+
lok 	斫	*+
lok 	衮	 +
lokb	磺	*+
lokr	硎	*+
lol 	矿	*+
lol 	砬	*+
lolb	矿	 +
lolf	磅	 +
lolk	矿	 +
lolk	磙	*+
loln	碲	*+
lolo	磊	*+
lolo	碚	*+
lolp	礅	*+
lolu	砺	*+
lolv	砺	*+
lolw	磁	 +
lomc	磷	 +
lomf	码	 +
lomr	砚	*+
loms	磷	 +
lon 	确	*+
lon 	碉	 +
lone	碹	*+
lonf	砣	*+
long	亳	 +
lonl	炮	 +
lonm	毫	 +
lono	高	 +
lono	碉	 +
lono	硐	*+
lonp	碗	*+
lonq	豪	 +
lonr	亮	 +
lont	亭	 +
lonu	膏	 +
lonu	敲	 +
lonv	碉	 +
lonv	确	 +
lonz	碇	*+
loo 	石	*+
loo 	硷	 +
loob	颤	*+
loof	鹯	*+
loog	瓤	 +
looh	禀	*+
look	襄	 +
loom	毡	 +
loos	禀	*+
loot	颤	*+
lop 	破	*+
lop 	砰	*+
lopg	碑	 +
lopo	硇	*+
lopo	硌	*+
lopr	硚	*+
lopt	砾	*+
lopx	硇	*+
lopz	砭	*+
loqa	砖	 +
loqr	硗	*+
lor 	剖	*+
lor 	竞	 +
lor 	矶	*+
lor 	砾	*+
lor 	兖	 +
lora	礴	*+
lora	矾	 +
lorb	磺	*+
lorb	碘	 +
lorc	砜	*+
lorf	硭	*+
lorj	礤	*+
lorq	礞	*+
lorr	矶	*+
lorr	竞	 +
lors	礤	*+
lorw	磁	 +
lorx	砜	*+
lorx	砹	*+
los 	京	*+
los 	砂	 +
losb	朱	 +
losf	鹫	*+
losk	就	 +
loss	朱	 +
lost	碟	*+
losu	硝	*+
lot 	硬	*+
lot 	硕	*+
lotb	硕	*+
lote	碴	*+
lotm	碴	*+
lots	硫	*+
lotx	硬	 +
lotz	础	 +
loui	硁	*+
loum	碜	*+
lout	磉	*+
louu	硼	*+
louy	硁	*
lov 	碉	*+
lov 	碓	*+
lov 	砩	*+
lovf	礁	*+
lovf	砟	*+
low 	亨	*+
low 	泵	*+
low 	瓿	*+
lowb	矶	*+
lowf	烹	 +
lowm	砀	 +
lowt	砾	*+
lowt	磲	*+
lox 	砖	*+
lox 	砑	 +
loxa	砥	*+
loxe	砥	*+
loy 	砑	*+
loyf	磕	*+
loyr	硗	*+
loyu	砝	*+
loyy	硅	*+
loz 	享	*+
loza	孰	 +
lozb	郭	 +
lozf	熟	 +
lozf	鹑	 +
lozh	憝	*+
lozj	亸	*+
lozo	砧	*+
lozp	敦	 +
lozx	孰	 +
lozy	塾	*+
lozz	孰	 +
lo, 	ろ	*+
lo, 	ぉ	*
lo. 	ロ	*+
lo. 	ォ	*
lp  	厂	*+
lp  	广	 +
lp  	丆	*+
lpa 	府	*+
lpa 	卞	*+
lpab	腐	 +
lpdb	愿	 +
lpde	夜	 +
lpdh	愿	 +
lpdk	厩	*+
lpds	原	 +
lpdt	愿	 +
lpg 	庳	*+
lpl 	厄	*+
lpm 	彦	*+
lpmb	颜	 +
lpmt	颜	 +
lpnb	赝	*+
lpnm	麴	*+
lpok	褒	*+
lpp 	产	 +
lpq 	廉	*+
lpqg	庳	 +
lpqn	麸	*+
lpr 	铲	*+
lps 	产	 +
lpsr	铲	 +
lpt 	顾	 +
lpt 	庥	*+
lptb	顾	 +
lpth	面	 +
lpto	面	 +
lpty	面	 +
lpu 	夜	 +
lpu 	么	 +
lpu 	庅	*+
lpv 	雁	*+
lpv 	广	 +
lpvb	赝	*+
lpvf	鹰	*+
lpvh	应	 +
lpvu	膺	*+
lpx 	麦	 +
lq  	痛	*+
lqbk	裹	 +
lqby	廛	*+
lqe 	童	*+
lqe 	厘	*+
lqfy	廛	*+
lqk 	裹	*+
lqn 	廉	*+
lqnn	亩	 +
lqnu	耦	*+
lqnw	递	*+
lqo 	亩	*+
lqru	毅	*+
lqtk	裹	 +
lqv 	豪	*+
lr  	竞	*+
lrc 	廑	*+
lrc 	飒	 +
lrcn	庹	*+
lrd 	厝	*+
lreb	广	 +
lrf 	庶	*+
lrff	鹧	*+
lrfw	遮	*+
lrj 	厅	*+
lrkh	厅	 +
lrkj	厅	 +
lrl 	辨	*+
lrl 	亢	 +
lrn 	席	*+
lrnd	耢	*+
lrok	衮	 +
lror	兖	 +
lrqd	励	 +
lrqu	厉	 +
lrt 	颃	*+
lrtb	颃	 +
lru 	度	*+
lrv 	亮	*+
lrx 	飒	*+
lrz 	亢	*+
ls  	应	*+
lsa 	京	*+
lsaf	鹫	*+
lsak	就	 +
lse 	应	 +
lsl 	辫	*+
lsnd	耢	*+
lsno	耥	*+
lsnp	厂	 +
lsp 	耖	*+
lsv 	砂	*+
lt  	床	*+
lta 	耘	*+
lti 	厅	*+
ltk 	新	 +
ltm 	厢	*+
ltmp	厦	*+
ltmr	亲	 +
ltn 	亲	*+
ltn 	床	 +
ltt 	麻	*+
ltte	靡	*+
ltth	摩	 +
lttm	糜	*+
lttm	麾	*+
ltto	磨	*+
ltts	靡	*+
ltts	縻	*+
lttu	麽	*+
lttu	魔	 +
lttv	魔	 +
lttw	麽	*+
ltu,	っ	*
ltu.	ッ	*
ltv 	亭	*+
lu  	离	*+
lu  	膏	*+
lua 	广	 +
lubp	竣	 +
lui 	序	*+
luk 	衮	*+
lul 	龙	*+
lulb	龚	 +
lulk	袭	 +
lulr	聋	 +
luly	垄	 +
luly	垅	 +
lur 	兖	*+
lurp	竣	 +
luv 	膏	*+
luw 	返	*+
lux 	反	*+
lu, 	る	*+
lu, 	ぅ	*
lu. 	ル	*+
lu. 	ゥ	*
lv  	广	*+
lvd 	励	*+
lve 	离	 +
lvs 	辣	*+
lvs 	竦	*+
lvv 	魔	*+
lvy 	厉	*+
lw  	磁	*+
lwa 	玄	*+
lwa,	ゎ	*
lwa.	ヮ	*
lwbj	率	 +
lwf 	烹	*+
lwi 	亨	*+
lwlh	慈	 +
lwlw	兹	 +
lwlz	孳	*+
lwn 	辽	 +
lwn 	逦	*+
lwns	牵	 +
lwq 	畜	*+
lwv 	雍	*+
lwvw	瓮	 +
lwvx	饔	*+
lwvy	壅	*+
lwwk	断	 +
lx  	夜	*+
lx  	疯	*+
lxa 	底	*+
lxb 	郊	*+
lxd 	效	*+
lxe 	底	*+
lxl 	庵	*+
lxl 	辨	 +
lxp 	效	*+
lxuu	离	 +
lxv 	疯	*+
lxx 	交	*+
ly  	座	*+
lya 	压	*+
lya,	ゃ	*
lya.	ャ	*
lybk	亵	*+
lyda	厨	 +
lye 	庄	*+
lye,	ぇ	*
lye.	ェ	*
lyfp	廒	*+
lyhp	庆	 +
lyi,	ぃ	*
lyi.	ィ	*
lykk	亵	*+
lyl 	辨	*+
lyoa	厨	 +
lyo,	ょ	*
lyo.	ョ	*
lyrk	亵	*+
lyu,	ゅ	*
lyu.	ュ	*
lyzk	亵	*+
lz  	症	*+
lzb 	郭	*+
lzbj	亸	*
lzj 	享	*+
lzj 	耔	*+
lznf	鹑	*+
lzo 	站	*+
lzo 	店	 +
lzp 	敦	*+
lzph	憝	*+
lzqf	庐	 +
lzrw	递	*+
lzz 	孰	*+
lzzf	熟	 +
lzzy	塾	*+
m   	满	*+
ma  	买	*+
mac 	睑	*+
mad 	类	*+
madb	类	 +
madk	粮	 +
madk	阆	 +
madt	类	 +
mae 	睑	*+
majw	球	 +
makp	胧	 +
makp	眬	*
mal 	胧	*+
man 	粮	*+
man 	阆	*+
mao 	合	*+
maob	睑	 +
maqe	阈	 +
mase	睑	 +
mav 	驰	*+
maxf	胧	 +
maxf	眬	*+
may 	矜	*+
ma, 	ま	*+
ma. 	マ	*+
mb  	须	*+
mba 	贝	*+
mba 	县	 +
mbaa	赙	*+
mbab	赊	*+
mbaf	贱	 +
mbaj	贼	 +
mbaq	贱	 +
mbar	赃	 +
mbas	赊	*+
mbaw	赇	*+
mbax	贼	 +
mbb 	赠	*+
mbbb	赊	*+
mbbd	赠	 +
mbbf	赚	 +
mbbs	赊	*+
mbbz	贬	*+
mbcb	赆	*+
mbd 	粉	*+
mbd 	盼	 +
mbd 	氆	*+
mbdm	赐	 +
mbdm	赗	*+
mbe 	赐	*+
mbe 	瞪	 +
mbed	关	 +
mbed	氆	 +
mbeh	悬	 +
mbei	阙	*+
mbek	账	*+
mbes	县	 +
mbew	糍	*+
mbez	赋	 +
mbff	赕	*+
mbfk	赈	*+
mbgn	关	 +
mbh 	赌	*+
mbia	赙	*+
mbj 	购	 +
mbjd	赎	*+
mbjm	赎	*+
mbjp	财	 +
mbjy	购	 +
mbk 	贱	*+
mbkf	糕	*+
mblh	赅	*+
mblo	赔	*+
mblu	贩	 +
mbly	赃	 +
mbmb	赑	*+
mbme	罂	 +
mbmf	鹦	*+
mbmg	婴	 +
mbmu	罂	 +
mbn 	闪	*+
mbn 	赇	*+
mbn 	赒	*
mbne	贮	*+
mbni	赡	 +
mbno	赒	*+
mbnt	贮	*+
mbnu	购	 +
mbod	氆	*+
mbor	阅	 +
mbor	贶	*+
mbp 	败	*+
mbph	悬	 +
mbpo	赂	*+
mbps	县	 +
mbpz	贬	*+
mbq 	赚	*+
mbqj	阐	 +
mbqp	睇	 +
mbr 	则	*+
mbrr	赃	 +
mbu 	财	*+
mbuo	贻	*+
mbv 	赡	*+
mbw 	赋	*+
mbx 	贿	*+
mbxd	赎	*+
mbxu	贿	 +
mbyb	赎	*+
mbyd	赌	 +
mbym	赎	*+
mbz 	眨	*+
mbzo	贴	 +
mc  	瞩	*+
mc  	骚	*+
mca 	闽	*+
mcb 	邻	*+
mcc 	眵	*+
mcc 	蟊	*+
mce 	瞌	*+
mce 	阖	*+
mceb	瞆	 +
mceb	阓	 +
mcl 	粑	*+
mcn 	释	*+
mco 	粞	*+
mcol	辟	 +
mcpu	瞩	 +
mcr 	粼	*+
mcrs	瞟	*+
mcs 	阑	*+
mcsb	邻	 +
mcsr	粼	 +
mcsw	遴	 +
mcu 	瞩	 +
mcua	团	 +
mcv 	骚	*+
mcw 	遴	*+
mcwc	瞩	 +
md  	彻	*+
md  	盼	*+
mda 	斗	 +
mdbs	了	 +
mdd 	阊	*+
mdee	阘	*+
mdeq	粮	 +
mdg 	阎	*+
mdi 	鼎	*+
mdil	阉	 +
mdj 	料	*+
mdk 	眼	*+
mdn 	类	*+
mdo 	间	*+
mdql	阉	 +
mdv 	盼	*+
mdv 	馍	 +
mdw 	闼	*+
mdx 	助	*+
mdy 	助	*+
mdy 	鼎	 +
me  	且	*+
meb 	具	*+
mee 	闩	*+
mee 	睁	 +
mefl	闿	*+
meg 	阎	*+
mei 	籼	*+
mel 	盹	*+
menc	瞬	 +
mens	瞬	 +
menu	阌	*+
meo 	凹	*+
mer 	兕	*+
mes 	县	 +
mesh	悬	 +
mess	县	 +
met 	睬	*+
mev 	翻	*+
mew 	毽	*+
me, 	め	*+
me. 	メ	*+
mf  	验	*+
mfa 	马	*+
mfa 	驰	 +
mfa 	验	 +
mfa 	骅	*+
mfab	验	 +
mfac	验	 +
mfae	验	 +
mfak	驻	 +
mfbb	阏	*+
mfbk	骈	*+
mfc 	驶	*+
mfcn	驿	*+
mfcs	骠	*+
mfcz	骣	*+
mfd 	驮	*+
mfd 	驲	*+
mfdo	骑	 +
mfdq	骝	*+
mfeh	骕	*+
mfek	阛	 +
mfeo	骄	 +
mfer	骕	*
mfes	骕	*
mfeu	骎	 +
mff 	驴	*+
mff 	毯	*+
mff 	驷	*+
mffb	骥	*+
mffe	骟	*+
mffg	驿	*+
mffm	骗	*+
mffo	驱	 +
mffx	驱	 +
mffy	驿	*+
mfg 	骄	*+
mfgo	骄	 +
mfgr	骄	 +
mfh 	骏	*+
mfik	骋	*+
mfjd	骙	*+
mfjn	骙	*
mfk 	眶	*+
mfkb	骐	*+
mfl 	骊	*+
mfl 	骧	*+
mfl 	骍	*+
mflb	骊	 +
mflh	骇	*+
mflk	骧	*+
mfm 	驵	*+
mfmb	阗	 +
mfmf	骉	*+
mfn 	粝	*+
mfne	驺	*+
mfnf	驼	*+
mfno	驹	*+
mfns	骔	*+
mfo 	验	 +
mfod	骃	*+
mfoo	眍	 +
mfoq	骝	*+
mfov	糊	*+
mfp 	骢	*+
mfpa	驸	*+
mfph	骢	 +
mfpj	骅	*+
mfpo	骆	*+
mfpo	骄	 +
mfpr	骄	 +
mfqk	骋	*+
mfqr	骁	*+
mfqs	骡	*+
mfqt	骒	*+
mfr 	骎	*
mfrb	骤	 +
mfrk	骤	 +
mfrq	骤	 +
mfrq	骅	 +
mfs 	驯	*+
mfu 	驭	*+
mfu 	糊	*+
mfuc	骚	 +
mfum	骖	*+
mfum	骦	*+
mfuo	骀	*+
mfup	骏	 +
mfuq	驿	*+
mfv 	骑	*+
mfv 	骓	*+
mfx 	眍	*+
mfxx	驳	*+
mfy 	释	*+
mfyg	释	 +
mfyr	骁	*+
mfzf	驴	 +
mg  	购	*+
mge 	睡	*+
mgiu	瞍	 +
mgj 	闬	*+
mgjy	睡	 +
mgn 	关	 +
mgp 	数	*+
mgr 	睨	*+
mgr 	阋	*+
mgry	睡	 +
mgu 	瞍	*+
mgx 	娄	*+
mh  	德	*+
mh  	闷	*+
mha 	悉	*+
mha 	闷	 +
mha 	懑	*+
mhe 	阈	*+
mhf 	瞅	*+
mho 	睹	*+
mho 	阇	*
mhu 	精	 +
mhu 	睛	 +
mhv 	闷	*+
mhx 	睃	*+
mi  	门	*+
miai	衔	*+
miai	术	 +
miak	往	 +
miat	衔	*+
miat	徐	 +
miat	术	 +
mibh	徐	 +
mibh	徉	*+
mibh	怂	 +
mibr	耸	*+
mibz	从	 +
micd	彻	 +
mida	得	 +
midk	很	 +
mie 	律	*+
miee	徭	*+
mieh	惩	 +
miei	径	 +
miep	微	 +
miep	徽	 +
miep	霉	 +
miep	徵	 +
mieu	徭	*+
miez	征	 +
mif 	彷	*+
mifm	遍	 +
mig 	旁	 +
migi	冲	 +
migt	冲	 +
migu	瞍	 +
mij 	德	 +
mijh	德	 +
mikh	惩	 +
mikm	循	 +
mikp	徵	 +
mil 	徕	*+
milf	旁	 +
mim 	徂	*+
mimi	衢	*+
mimt	衢	*+
mind	徇	*+
mio 	訚	*+
mioo	徊	*+
mip 	彼	*+
mipk	徨	*+
mipp	徼	*+
miq 	釉	*+
miqp	霉	*+
mirf	鸻	*+
miri	行	 +
mirp	微	 +
mirp	瞰	 +
mirp	阚	*+
mirs	徘	*+
miru	役	*+
mis 	瞓	*+
misi	径	 +
miso	徜	*+
misp	徽	 +
mit 	彻	 +
mitp	彻	 +
miue	徭	*+
miui	径	 +
miui	衡	 +
miut	衡	 +
miuu	徭	*+
miuy	径	 +
miv 	复	 +
miv 	佛	 +
mivp	复	 +
mivs	御	 +
miwh	愆	*+
miwi	衍	*+
miwi	衙	*+
miwi	卫	 +
miwp	御	 +
miwp	後	 +
miwp	后	 +
miws	御	 +
miwt	衍	*+
miwt	衙	*+
miwt	卫	 +
mixm	循	 +
miya	待	 +
miyi	街	 +
miyt	街	 +
miyz	徒	 +
mizz	徙	*+
mi, 	み	*+
mi. 	ミ	*+
mj  	册	*+
mjb 	阗	*+
mjd 	瞪	*+
mjed	睽	 +
mjed	阕	 +
mjez	睫	 +
mjgn	睽	 +
mjgn	阕	 +
mjj 	粹	*+
mjmb	阗	 +
mjn 	闹	*+
mjou	糊	*+
mjqa	团	 +
mjqs	阑	 +
mjv 	贼	*+
mjz 	睫	*+
mk  	往	*+
mke 	闰	*+
mkj 	开	 +
mkl 	眈	*+
mkn 	睽	*+
mkn 	阕	*+
mkv 	驻	 +
ml  	毛	*+
mla 	了	 +
mle 	粒	*+
mleo	糖	*+
mlew	糠	*+
mlh 	阂	*+
mlk 	断	 +
mln 	闹	*+
mln 	睐	*+
mlq 	瞳	*+
mlr 	闶	*+
mls 	县	 +
mlsh	悬	 +
mlss	县	 +
mlul	胧	 +
mlv 	粝	*+
mlw 	眩	*+
mlyy	睚	*+
mm  	循	*+
mmad	阒	*+
mmc 	瞵	*+
mmcs	瞵	 +
mme 	粗	*+
mmf 	闯	*+
mmm 	毳	*+
mmn 	眯	*+
mmn 	睬	 +
mmp 	彩	 +
mmt 	糅	*+
mmv 	瞿	*+
mmvm	氍	*+
mmvu	矍	*+
mmw 	眯	*+
mn  	米	*+
mn  	阑	*+
mna 	球	*+
mnbf	鹬	*+
mnbi	瞻	 +
mndl	瞑	*+
mne 	睁	*+
mnfo	瞎	*+
mng 	阎	*+
mnho	瞎	*+
mnil	阄	 +
mnli	瞻	 +
mnof	鹬	*+
mnql	阄	 +
mnr 	眈	*+
mnrf	鹬	*+
mnrs	粽	 +
mns 	粽	*+
mnx 	阄	*+
mn, 	ん	*+
mn. 	ン	*+
mo  	目	*+
moa 	睑	*+
moca	团	 +
moj 	阐	*+
mon 	阛	*
moo 	问	*+
moo 	闾	 +
mooj	阐	 +
mooo	板	 +
mopo	闾	 +
mot 	困	*+
mot 	阃	*+
mou 	团	 +
mov 	闾	*+
mox 	眠	*+
mox 	团	 +
mo, 	も	*+
mo. 	モ	*+
mp  	矛	*+
mp  	御	*+
mpa 	鍪	*+
mpad	糗	*+
mpaq	阀	*+
mpaz	眨	 +
mpbd	糌	*+
mpc 	蝥	*+
mpd 	务	*+
mpd 	粕	*+
mpfd	糇	*+
mpg 	睥	*+
mpg 	婺	*+
mpj 	辟	*+
mpm 	瞀	*+
mpmd	糗	*+
mpmf	骛	*+
mpnf	鹜	*+
mpo 	阁	*+
mppd	糌	*+
mpqg	睥	 +
mpv 	御	*+
mpx 	敉	*+
mpz 	眨	*+
mq  	骤	*+
mqa 	瞆	*
mqa 	阓	*
mqb 	鄱	*+
mqee	翻	 +
mqi 	闸	*+
mqo 	番	*+
mqoc	糨	*+
mqrb	粪	 +
mqu 	睦	*+
mquc	糨	*+
mr  	阅	*+
mra 	眺	*+
mrb 	粪	*+
mrbb	眺	 +
mrdd	馍	 +
mreb	瞒	*+
mrfd	糟	*+
mri 	删	*+
mrj 	闻	*+
mrl 	见	*+
mrnb	瞒	*+
mrnq	蒙	 +
mrod	糟	*+
mrq 	瞄	*+
mrv 	赃	*+
mrww	糍	*+
mrz 	觃	*+
ms  	县	*+
msa 	县	 +
mse 	闫	*+
msny	瞠	*+
msow	糙	*+
msp 	眇	*+
msph	悬	 +
msps	县	 +
mst 	颣	*
mstb	颣	 +
msv 	瞬	*+
mt  	闲	*+
mta 	须	 +
mtg 	媭	*
mti 	盯	*+
mtly	眄	*+
mtmb	须	 +
mtmg	媭	 +
mtn 	柔	*+
mtn 	闲	 +
mtnf	鹇	*+
mtp 	睇	*+
mtqx	粳	 +
mtrp	瞰	*+
mtrp	阚	*+
mtx 	粳	*+
mu  	精	*+
mu  	睛	*+
mua 	县	 +
mubb	阏	*+
mubp	睃	 +
mudm	糁	 +
mue 	闲	 +
mufd	氇	*+
muh 	悬	*+
muj 	盱	*+
mum 	糁	*+
muo 	眙	*+
mup 	闭	*+
muq 	释	*+
mur 	糯	*+
murp	睃	 +
mus 	眸	*+
mus 	毪	*+
mutr	糯	 +
muum	糁	 +
muv 	睛	*+
mu, 	む	*+
mu. 	ム	*+
mv  	行	*+
mve 	睢	*+
mve 	雎	*+
mvf 	瞧	*+
mvo 	瞻	*+
mw  	徐	*+
mwgo	阔	*+
mwj 	闱	*+
mwn 	迷	*+
mwos	闱	 +
mwv 	遴	*+
mwwf	关	 +
mwx 	闵	*+
mx  	曼	*+
mx  	驱	*+
mxa 	瞩	 +
mxd 	阍	*+
mxl 	阉	*+
mxu 	闳	*+
mxv 	驱	*+
my  	门	*+
mybw	闼	 +
myby	睦	 +
myd 	睹	*+
mye 	睦	*+
mypd	睹	 +
mypd	阇	 +
myry	睦	 +
myuf	瞌	 +
myuf	阖	 +
myv 	赃	*+
myw 	闼	*+
myy 	闺	*+
myy 	眭	*+
myzu	糈	*+
mz  	征	*+
mz  	徒	*+
mzez	睫	 +
mzf 	眦	*+
mzj 	籽	*+
mzo 	毡	*+
mzo 	粘	*+
m,  	ん	*+
m.  	ン	*+
n   	南	*+
na  	求	*+
na  	寅	*+
naa 	守	*+
naa 	勺	*+
naa 	々	 +
nad 	献	*+
nad 	宊	*+
nae 	丹	*+
naem	彤	 +
najq	匍	 +
nakp	宠	 +
nal 	宠	*+
naxf	宠	 +
na, 	な	*+
na. 	ナ	*+
nb  	赛	*+
nba 	内	*+
nba 	穴	*+
nba 	窬	*+
nbad	突	 +
nbaf	然	 +
nbar	窬	*+
nbb 	肉	*+
nbbf	窑	*+
nbbo	容	 +
nbbs	窿	*+
nbbw	邃	*+
nbbz	窆	*+
nbc 	穸	*+
nbcc	窜	*+
nbcd	窃	 +
nbce	窟	*+
nbcu	窟	*+
nbd 	实	*+
nbd 	穷	 +
nbe 	匀	*+
nbe 	冈	 +
nbe 	窀	*+
nbee	冈	 +
nbef	罔	 +
nbeo	窘	*+
nber	刚	 +
nbeu	窃	 +
nbf 	罔	*+
nbg 	罕	*+
nbgg	窳	*+
nbgs	窜	*+
nbh 	解	*+
nbi 	空	*+
nbik	窍	 +
nbil	罔	 +
nbjd	窦	*+
nbjm	窦	*+
nbk 	究	*+
nbld	窨	*+
nbmg	窭	*+
nbmu	窃	 +
nbn 	内	*+
nbn 	穴	*+
nbn 	帘	 +
nbo 	官	*+
nbob	窝	 +
nbp 	内	*+
nbp 	窒	 +
nbpb	宾	 +
nbpc	窗	 +
nbpo	窗	 +
nbpp	窍	 +
nbpq	窗	 +
nbpz	窆	*+
nbq 	窥	*+
nbq 	穹	*+
nbqj	觯	 +
nbqo	窝	 +
nbqr	窥	 +
nbqt	窠	 +
nbr 	窕	*+
nbrb	窕	 +
nbso	窖	*+
nbsq	穷	 +
nbtf	罔	 +
nbtu	冈	 +
nbue	窑	*+
nbuh	窗	 +
nbuu	窑	*+
nbv 	宾	*+
nbvf	窄	 +
nbw 	逭	*+
nbwd	窈	*+
nbws	繇	*+
nbwu	窑	*+
nbwy	洼	*+
nbx 	穿	*+
nby 	穿	*+
nbyb	窦	*+
nbym	窦	*+
nc  	够	*+
nca 	触	*+
ncb 	郓	*+
nce 	宐	*
ncj 	军	*+
ncl 	色	*+
ncmb	宾	 +
ncn 	奂	*+
ncp 	宛	*+
ncp 	幄	*+
ncp 	皲	*+
ncpf	鹓	*+
ncpr	剜	*+
ncq 	象	*+
ncr 	免	*+
ncra	兔	*+
ncrd	勉	 +
ncrw	逸	 +
ncw 	运	*+
nd  	突	*+
ndb 	郇	*+
ndbs	寮	 +
ndca	冤	 +
nddn	幂	*+
nde 	宐	*+
ndfu	幔	 +
ndg 	宴	*+
ndj 	斛	*+
ndl 	冥	*+
ndm 	帽	*+
ndo 	旬	*+
nds 	解	*+
ndsc	蟹	*+
ndsr	幌	*+
ndsw	邂	*+
ndto	寄	 +
ndv 	寞	*+
ndx 	筋	*+
ndy 	筋	*+
ne  	宣	*+
ne  	角	 +
nea 	冤	*+
nea 	写	 +
neb 	邹	*+
nede	宣	 +
nee 	宣	 +
nee 	刍	*+
neem	寥	 +
neh 	急	*+
nei 	岛	*+
nej 	争	*+
nek 	帐	*+
nem 	寥	*+
nenb	邹	 +
nene	刍	*+
nenp	皱	 +
nenv	雏	 +
neo 	同	*+
neoq	富	 +
neoq	幅	 +
neoq	匐	*+
nep 	皱	*+
nepf	煞	*+
neq 	家	 +
neq 	冢	*+
neqa	冢	*+
neqb	寅	 +
nev 	雏	*+
nez 	定	 +
ne, 	ね	*+
ne. 	ネ	*+
nf  	穷	*+
nfa 	鸟	*+
nfa 	帱	*+
nfb 	幞	*+
nfed	幞	 +
nfek	寰	 +
nffh	宪	 +
nfk 	宸	*+
nfl 	它	*+
nfn 	灾	*+
nfn 	实	 +
nfnc	触	 +
nfnf	鸵	*+
nfo 	害	*+
nfoo	豁	*+
nfor	割	*+
nfow	豁	*+
nfru	鹱	*+
nfsu	寂	 +
ng  	安	*+
nga 	觚	*+
ngeu	寝	 +
ngff	焰	 +
ngl 	宅	*+
ngn 	觚	*+
ngnf	写	 +
ngnf	鹐	*+
ngqb	寐	*+
ngr 	寝	*+
ngt 	案	*+
ngwo	寤	*+
ngx 	安	 +
ngys	寐	*+
ng, 	ん	*+
ng. 	ン	*+
nh  	忽	*+
nhfh	宪	 +
nhft	宁	 +
nhj 	擎	*+
nhmb	帻	*+
nhnq	甯	*+
nho 	害	*+
nhoo	豁	*+
nhor	割	*+
nhow	豁	*+
nhp 	宓	*+
nhpc	蜜	 +
nhpe	密	 +
ni  	巾	*+
nii 	审	*+
nij 	匍	*+
nio 	警	*+
nio 	訇	*+
niq 	宙	*+
niqi	审	 +
ni, 	に	*+
ni. 	ニ	*+
nj  	角	*+
nja 	察	*+
njb 	寒	*+
njbh	搴	 +
njcs	觫	 +
njh 	搴	*+
nji 	謇	*+
njlk	褰	*+
njmb	赛	 +
njmf	骞	*+
njn 	觖	*+
njoz	蹇	*+
njrs	察	 +
njt 	寨	*+
njy 	塞	 +
nk  	农	*+
nk  	窍	*+
nka 	宝	*+
nke 	写	*+
nkeb	宾	 +
nkf 	写	*+
nkl 	宄	*+
nkn 	农	 +
nknb	宝	 +
nkv 	窍	*+
nkvb	宝	 +
nkwb	宝	 +
nkx 	宄	*+
nkz 	宄	*+
nl  	包	*+
nla 	寮	*+
nlad	帜	 +
nlbi	詹	 +
nldj	幛	*+
nle 	丹	*+
nlj 	宰	*+
nlj 	丹	 +
nlk 	裘	*+
nlk 	袅	*+
nlm 	彤	*+
nlo 	宕	*+
nlp 	危	 +
nlp 	厃	*+
nlq 	幢	*+
nlri	詹	 +
nlul	宠	 +
nm  	勿	*+
nmb 	负	*+
nme 	宜	*+
nmf 	惊	*+
nmh 	忽	 +
nmn 	宩	*+
nmp 	勿	 +
nmp 	雕	 +
nmq 	幡	*+
nmq 	审	 +
nmr 	刎	*+
nmx 	幔	*+
nn  	久	*+
nn  	象	*+
nnbd	奂	 +
nnca	冤	 +
nnd 	奂	*+
nne 	册	 +
nner	删	 +
nnf 	灸	*+
nnn 	久	 +
nnrd	奂	 +
nnv 	象	*+
nn, 	ん	*+
nn. 	ン	*+
no  	周	*+
no  	宫	 +
noa 	实	*+
noae	帼	 +
nob 	帜	*+
nobb	奂	 +
nocc	够	 +
nod 	劬	*+
noh 	帼	*+
noj 	觯	*+
noka	帼	 +
nol 	包	 +
nolr	刨	 +
nomb	实	 +
non 	寰	*+
nonf	鸲	*+
noo 	句	*+
noo 	宫	 +
nooj	觯	 +
nopo	宫	 +
norb	奂	 +
nov 	宫	 +
now 	迥	*+
noxb	实	 +
no, 	の	*+
no. 	ノ	*+
np  	危	*+
npd 	帕	*+
npe 	室	*+
npo 	客	*+
npob	额	 +
npob	宾	 +
npot	额	 +
npr 	帆	*+
nptd	宿	*+
npx 	救	 +
npx 	帔	*+
nq  	富	*+
nqh 	匆	*+
nqj 	用	*+
nql 	甩	*+
nql 	龟	 +
nqnu	寓	*+
nqo 	甸	*+
nqx 	匆	*+
nr  	宽	*+
nra 	帆	*+
nra 	窬	*+
nrad	突	 +
nraf	然	 +
nrar	窬	*+
nrbf	窑	*+
nrbs	窿	*+
nrbw	邃	*+
nrbz	窆	*+
nrc 	穸	*+
nrcc	窜	*+
nrcd	窃	 +
nrce	窟	*+
nrcu	窟	*+
nrd 	穷	 +
nrdd	寞	 +
nrdn	幂	*+
nre 	匀	*+
nre 	宦	*+
nre 	窀	*+
nreo	窘	*+
nreu	窃	 +
nrg 	罕	*+
nrgg	窳	*+
nrgs	窜	*+
nri 	空	*+
nri 	刨	 +
nrik	窍	 +
nrj 	册	 +
nrjd	窦	*+
nrjm	窦	*+
nrk 	究	*+
nrl 	冗	*+
nrl 	凫	*+
nrld	窨	*+
nrma	宽	 +
nrmg	窭	*+
nrmr	宽	 +
nrmu	窃	 +
nrn 	帘	*+
nrob	窝	 +
nrp 	窒	*+
nrpc	窗	 +
nrpo	窗	 +
nrpp	窍	 +
nrpq	窗	 +
nrpz	窆	*+
nrq 	窥	*+
nrq 	穹	*+
nrq 	冢	*+
nrqo	窝	 +
nrqr	窥	 +
nrqt	窠	 +
nrr 	完	*+
nrr 	删	 +
nrr 	窕	 +
nrra	冠	 +
nrrb	窕	 +
nrru	寇	*+
nrs 	宗	 +
nrso	窖	*+
nrsq	穷	 +
nrue	窑	*+
nruh	窗	 +
nruu	窑	*+
nrvf	窄	 +
nrwd	窈	*+
nrwu	窑	*+
nrwy	洼	*+
nrx 	穿	*+
nry 	穿	*+
nryb	窦	*+
nrym	窦	*+
nrz 	冗	*+
nrz 	凫	*+
ns  	宗	*+
nsa 	尔	*+
nsa 	宗	 +
nser	觥	*+
nsj 	牢	*+
nska	玺	 +
nsmb	宾	 +
nsn 	帙	*+
nsr 	宪	*+
nsu 	宵	*+
nsw 	迩	*+
nt  	额	*+
ntdd	寡	*+
nti 	宁	*+
ntmd	寡	*+
ntn 	宋	*+
ntn 	枭	*+
ntn 	檠	*+
ntqb	寅	 +
nu  	寂	*+
nua 	勾	*+
nuj 	宇	*+
nu, 	ぬ	*+
nu. 	ヌ	*+
nv  	宫	*+
nv  	帷	*+
nvd 	觞	*+
nvdm	觞	 +
nve 	雕	*+
nve 	帷	 +
nve 	觞	 +
nvnf	鹤	*+
nvo 	寄	*+
nvs 	觫	*+
nvv 	帷	*+
nvwm	觞	 +
nw  	逸	*+
nwj 	帏	*+
nwn 	周	 +
nwn 	逑	*+
nwo 	容	*+
nwos	帏	 +
nx  	敬	*+
nxl 	龟	*+
nxr 	刚	*+
nxu 	宏	*+
nxu 	匈	*+
nxu 	宥	*+
nxv 	冈	*+
nxx 	网	*+
nxx 	冈	 +
ny  	塞	*+
nye 	冉	*+
nyj 	冉	*+
nyo 	周	 +
nyom	雕	 +
nyov	雕	 +
nyow	周	 +
nyya	帱	*+
nz  	定	*+
nzj 	字	*+
nzmb	帧	*+
nzo 	帖	*+
n,  	ん	*+
n.  	ン	*+
o   	〇	*+
oa  	贯	*+
oaa 	寸	 +
oaa 	团	 +
oab 	啷	*+
oad 	吠	*+
oad 	哙	 +
oadb	啷	 +
oado	呛	 +
oai 	喻	*+
oaj 	哗	*+
oajq	哺	 +
oajq	圃	 +
oakp	咙	 +
oal 	咙	*+
oam 	囵	*+
oan 	唉	*+
oao 	哈	*+
oap 	囹	*+
oap 	呤	*+
oaq 	战	 +
oaqd	哙	 +
oaqe	国	 +
oaqo	喊	 +
oaqr	戢	*+
oaqs	嘁	*+
oar 	刘	 +
oat 	囹	*+
oat 	呤	*+
oaur	喻	 +
oaxf	咙	 +
oay 	吟	*+
oayh	念	 +
ob  	圆	*+
ob  	鄙	*+
oba 	只	*+
oba 	叭	*+
oba 	囨	*+
obby	唑	*+
obd 	吩	*+
obe 	呸	*+
obef	嗌	*+
obeu	嗍	*+
obf 	囵	*+
obgo	啥	 +
obh 	咩	*+
obhi	嗟	*+
obi 	鄂	*+
obi 	郸	*+
obi 	吖	 +
obj 	哔	*+
obki	嗟	*+
obl 	噙	*+
obl 	吡	*+
oblu	噙	 +
obn 	囚	*+
obn 	叭	*+
obnl	圈	 +
obnp	圈	 +
obo 	啥	*+
obo 	噌	*+
obp 	呛	*+
obpd	喈	*+
obqd	噌	*+
obqj	啴	*+
obt 	哙	*+
obto	啊	 +
obue	嗡	*+
obv 	鄙	*+
obwu	噙	 +
obx 	图	*+
obxc	嗲	*+
oc  	嘱	*+
oca 	虽	*+
occ 	哆	*+
occa	啭	 +
oce 	嗑	*+
oceq	喙	*+
ocf 	呢	*+
ocja	啭	 +
ocl 	吧	*+
ocl 	邑	*+
ocn 	尺	*+
ocnr	唰	*+
oco 	哂	*+
ocol	噼	 +
ocp 	喔	*+
ocpu	嘱	 +
ocqa	啭	 +
ocrk	冁	*+
ocrs	嘌	*+
ocu 	嘱	 +
ocua	团	 +
ocv 	虽	*+
ocwc	嘱	 +
ocx 	啭	*+
od  	因	*+
od  	晋	*+
oda 	呔	*+
odaq	戬	*+
odbs	嘹	*+
odd 	唱	*+
ode 	叼	*+
odh 	恩	*+
odi 	喘	*+
odk 	哏	*+
odl 	喝	*+
odn 	因	 +
odnl	喝	 +
odo 	咖	*+
odo 	晋	 +
odp 	叨	*+
odr 	别	*+
odr 	咧	*+
odru	嘬	*+
odup	唧	*+
odv 	晋	*+
odw 	哒	*+
odx 	另	*+
odx 	叻	*+
ody 	另	*+
ody 	叻	*+
odyy	喹	*+
oe  	亚	*+
oe  	噩	*+
oeb 	哪	*+
oec 	嗤	*+
oec 	哕	*+
oed 	吴	*+
oee 	咄	*+
oeec	嗤	 +
oefa	嚼	*+
oefe	哑	 +
oeh 	啸	*+
oek 	呒	*+
oel 	吨	*+
oel 	囤	*+
oen 	咦	*+
oenp	嗳	*+
oenu	嗳	*+
oeot	嗝	*+
oeqa	啄	*+
oer 	喘	*+
oers	啸	 +
oesr	啸	 +
oet 	吨	*+
oetb	吨	 +
oetr	喘	 +
oeu 	咄	*+
oeuu	嘣	*+
oev 	噩	*+
of  	器	*+
ofa 	吓	*+
ofad	唳	*+
ofb 	噗	*+
ofc 	罗	*+
ofc 	啰	*+
ofdd	吃	 +
ofed	噗	 +
ofek	圜	 +
off 	啖	*+
offd	唠	*+
offk	哝	 +
offw	遐	*+
ofk 	哐	*+
ofl 	叱	*+
ofn 	咂	*+
ofnh	嗪	*+
ofnq	唪	*+
ofoo	呕	 +
ofp 	咔	*+
ofsv	罗	 +
ofu 	唛	*+
ofvd	嗾	*+
ofx 	呕	*+
og  	啤	*+
og  	蹈	*+
oga 	呱	*+
ogc 	唛	*+
oge 	唾	*+
ogi 	叫	*+
ogi 	唧	*+
ogiu	嗖	*+
ogjy	唾	 +
ogl 	吒	*+
ogl 	呒	 +
ogn 	吴	*+
ogn 	呱	 +
ogp 	唛	*+
ogry	唾	 +
ogu 	呶	*+
ogu 	嗖	*+
ogv 	蹈	*+
ogx 	囡	*+
oh  	啊	*+
oha 	恶	*+
oha 	吣	*+
ohb 	嘟	*+
ohdd	吃	 +
ohe 	国	 +
ohf 	啾	*+
ohj 	呼	*+
ohmb	啧	*+
ohnp	嗷	*+
ohp 	唛	*+
ohs 	嗉	*+
ohu 	圊	*+
ohx 	唆	*+
ohx 	嗳	*+
oi  	誓	*+
oigu	嗖	*+
oii 	呻	*+
oij 	哺	*+
oij 	圃	*+
oimb	唝	*+
oin 	吹	*+
oin 	敛	 +
oio 	唁	*+
oiqi	呻	 +
oiql	黾	 +
oix 	哦	*+
oj  	单	*+
oja 	喷	*+
ojb 	嗔	*+
ojci	嗽	*+
ojck	囔	*+
ojcr	喇	 +
ojd 	噔	*+
ojdu	嘲	 +
ojj 	叶	*+
ojj 	啐	*+
ojj 	围	 +
ojk 	哳	*+
ojl 	啦	*+
ojmb	嗔	 +
ojng	喃	*+
ojns	嗦	*+
ojnz	嚏	*+
ojo 	固	*+
ojo 	咕	*+
ojob	鄙	 +
ojpd	啪	*+
ojqa	团	 +
ojqb	咦	 +
ojr 	喇	*+
ojrb	喷	 +
oju 	嘲	*+
oju 	吱	*+
ok  	号	*+
ok  	跟	 +
oka 	国	 +
okb 	郢	*+
okbk	嘶	*+
okd 	吴	*+
oke 	呈	*+
okeb	吴	 +
oki 	听	 +
okk 	号	 +
oknf	鸮	*+
oko 	喊	*+
okv 	跟	 +
okw 	逞	*+
okzr	号	 +
okzx	饕	 +
ol  	严	*+
ola 	导	*+
ola 	嘹	*+
olbi	噘	*+
olc 	唛	*+
old 	呖	*+
old 	喑	*+
oldh	噫	*+
olf 	咴	*+
olg 	唼	*+
olh 	咳	*+
olhq	嚎	 +
olk 	哌	*+
oll 	巳	*+
oln 	嚷	*+
olnn	啼	*+
olno	嘀	 +
olnq	嚎	 +
olob	鄙	 +
olob	巽	 +
olok	嚷	 +
oloq	嚎	 +
olow	哼	 +
olow	选	 +
olp 	呃	*+
olp 	唛	 +
olq 	喱	*+
olr 	异	*+
olr 	吭	*+
olt 	噪	*+
oltt	嘛	*+
olul	咙	 +
olw 	哼	*+
olx 	咬	*+
om  	距	*+
oma 	母	*+
omb 	员	*+
omb 	呗	*+
omb 	贸	 +
ombb	郧	*+
ombd	勋	*+
ombg	嘤	 +
ome 	嗣	*+
ome 	咀	*+
omf 	吗	*+
omg 	喽	*+
ommb	贯	 +
omn 	咪	*+
omv 	嘭	*+
omyo	嗣	 +
on  	跑	*+
onb 	呐	*+
onb 	呙	 +
onbr	剐	 +
onc 	唤	*+
one 	喧	*+
onee	喧	 +
onez	啶	 +
onf 	鸣	*+
onf 	鹗	*+
onf 	鹮	*+
onfb	唤	 +
ong 	咤	*+
onhe	嘧	*+
onht	咛	 +
oni 	吊	*+
oni 	啕	*+
onj 	吊	*+
onj 	喃	*+
onj 	嚓	*+
onjs	嚓	*+
onjy	噻	*+
onk 	哝	*+
onl 	咆	*+
onm 	吻	*+
onm 	囫	*+
onmh	唿	*+
onnd	唤	 +
ono 	啁	*+
ono 	局	 +
onol	咆	 +
onpo	喀	*+
onr 	别	*+
onro	嗣	 +
ont 	咛	*+
onv 	呙	*+
onwu	啕	*+
onyo	啁	 +
onz 	啶	*+
oo  	口	*+
oo  	回	 +
oo  	囗	*+
ooad	哭	*+
ooao	器	 +
ood 	咽	*+
oodh	嗯	*+
ooe 	哑	*+
oojo	图	 +
ooka	啯	*+
oolo	图	 +
oolp	严	 +
oomb	圆	 +
oomf	骂	 +
oon 	圜	*+
ooo 	品	 +
ooo 	吕	 +
ooo 	回	 +
ooot	噪	 +
ooqb	郸	*+
ooqd	兽	*+
ooqj	单	 +
ooqk	冁	*+
ooql	鼍	*+
ooqq	战	 +
oor 	咒	*+
oorb	颚	 +
oorb	鄂	 +
oorf	鹗	*+
oort	颚	 +
ooto	嚣	*+
oov 	回	 +
op  	圈	*+
op  	严	 +
opa 	咐	*+
opa 	卟	*+
opad	嗅	*+
opb 	图	*+
opb 	咚	*+
opdc	唣	*+
opdf	唣	*+
opdj	嗥	*+
ope 	咿	*+
opfd	喉	*+
opfj	哗	 +
opg 	啤	 +
opi 	叩	*+
opj 	噼	*+
opl 	圈	 +
opm 	咱	*+
opmd	嗅	*+
opnd	噢	*+
opno	响	 +
opo 	咱	*+
opo 	吕	 +
opo 	咯	*+
opob	噢	*+
opp 	严	 +
opqg	啤	 +
opt 	咻	*+
opu 	吸	*+
opv 	严	 +
opx 	敛	*+
oq  	国	*+
oqb 	味	*+
oqe 	哩	*+
oqer	哓	 +
oqf 	嘿	*+
oqi 	呷	*+
oqi 	吲	*+
oqj 	哔	*+
oqjq	哔	 +
oqk 	喂	*+
oql 	黾	*+
oqn 	呋	*+
oqnf	鹠	*
oqnu	喁	*+
oqo 	留	*+
oqu 	喟	*+
oqv 	嚎	*+
oqw 	遛	*+
or  	回	*+
or  	唬	*+
orao	嗒	*+
oraq	戢	*+
orb 	哄	*+
orc 	叹	*+
orcd	嘞	*+
ord 	噶	*+
ordl	噶	 +
orfd	嘈	*+
orft	呓	 +
ori 	剑	*+
orjq	哗	 +
orl 	兄	*+
orl 	叽	 +
orlo	嚆	*+
orn 	吸	*+
ornd	唠	*+
oro 	喏	*+
oro 	嗒	*+
orod	嘈	*+
orok	哝	 +
orpo	嗬	*+
orq 	喵	*+
orq 	嚆	*+
orr 	园	*+
orrr	嗫	*+
orss	啡	*+
ort 	哚	*+
oruh	苏	 +
oruu	嗫	*+
orv 	唬	*+
orx 	哎	*+
orxo	喏	 +
oryt	呓	 +
orz 	呓	*+
orz 	叽	 +
os  	品	*+
os  	踪	*+
ose 	当	 +
oser	咣	*+
osg 	嘤	*+
osmb	唢	*+
osna	哟	*+
osnd	尝	 +
osnq	当	 +
oso 	当	 +
osp 	吵	*+
oss 	咝	*+
ost 	喋	*+
osu 	哨	*+
osv 	踪	*+
ot  	呆	*+
ota 	颚	*+
otde	喳	 +
oti 	叮	*+
otm 	喳	*+
otmb	颚	 +
otmp	嗄	*+
otmq	嘎	*+
otn 	困	*+
otn 	呆	 +
otn 	嗵	 +
otnw	嗵	 +
oto 	呵	*+
otqx	哽	 +
ott 	啉	*+
otts	噤	*+
otu 	唷	*+
otw 	嗵	*+
otx 	哽	*+
ou  	团	*+
oua 	囜	*+
oubp	唆	 +
oufd	噜	*+
ouj 	吁	*+
oun 	咏	*+
ounf	鹃	*+
oup 	团	 +
our 	吮	*+
our 	嚅	*+
ourp	唆	 +
ous 	哞	*+
outr	嚅	*+
ouut	嗓	*+
ouuu	啜	*+
ouv 	嚯	*+
ouvd	唉	 +
oux 	叹	*+
ov  	吕	*+
ove 	唯	*+
ovf 	咋	*+
ovf 	噍	*+
ovff	呒	 +
ovn 	噗	*+
ovnk	囔	*+
ovsi	嗽	*+
ovsr	喇	 +
ovz 	吃	*+
ov, 	ぉ	*+
ov. 	ォ	*+
ow  	响	*+
owa 	吆	*+
owb 	叽	*+
owd 	呦	*+
owf 	呜	*+
owh 	哜	*+
owj 	围	*+
own 	还	*+
own 	遐	*+
owo 	唔	*+
owo 	圄	*+
owos	围	 +
owp 	啵	*+
owr 	哜	*+
owvm	嗨	*+
owwb	叽	 +
owwe	咝	 +
owwf	咝	 +
owzp	衔	*+
ox  	民	*+
oxa 	团	 +
oxa 	嘱	 +
oxe 	囿	*+
oxf 	咴	*+
oxmb	贯	 +
oxn 	饕	*+
oxo 	嘀	*+
oxp 	呀	*+
oxph	愍	*+
oxu 	囿	*+
oxv 	毋	*+
oxx 	民	 +
oxx 	毋	 +
oxxn	唏	*+
oy  	嘴	*+
oybg	圉	 +
oybw	哒	 +
oydm	嘭	 +
oydo	嘻	*+
oye 	吐	*+
oye 	叼	 +
oye 	垩	*+
oye 	嗌	*+
oyf 	哧	*+
oyff	吓	 +
oyfp	嗷	*+
oyi 	吖	*+
oyj 	圉	*+
oynd	噎	*+
oyo 	咭	*+
oyok	园	 +
oyom	嘭	 +
oyoo	嘻	*+
oyp 	呀	*+
oypb	嘟	 +
oypd	嗜	*+
oypz	哮	*+
oyr 	哓	*+
oys 	味	*+
oyuf	嗑	 +
oyw 	哒	*+
oyy 	哇	*+
oyyr	哓	 +
oz  	跌	*+
oza 	跋	*+
oza 	踉	*+
ozaf	践	 +
ozak	踉	*+
ozao	跄	*+
ozaq	践	 +
ozau	跋	 +
ozax	跋	 +
ozb 	趴	*+
ozb 	蹭	*+
ozb 	蹬	*+
ozb 	碰	 +
ozba	蹲	*+
ozbb	踯	*+
ozbd	蹭	*+
ozbe	碰	 +
ozbi	蹉	*+
ozbj	跸	 +
ozbl	蜷	 +
ozbo	碰	 +
ozbp	跄	*+
ozbp	蜷	 +
ozbu	啮	*+
ozco	踞	*+
ozco	局	 +
ozd 	踹	*+
ozde	蹋	*+
ozdk	跟	 +
ozdk	跨	 +
ozdm	踢	 +
ozdo	跏	*+
ozdw	跶	*+
oze 	踢	*+
ozed	蹊	*+
ozeg	蹈	 +
ozeq	噱	*+
ozer	踹	 +
ozet	踩	*+
ozeu	蹦	*+
ozev	跃	*+
ozew	踺	*+
ozf 	呲	*+
ozfa	踌	*+
ozfb	蹼	 +
ozfc	躅	*+
ozfd	蹼	 +
ozfe	嘘	*+
ozff	距	 +
ozfh	跽	*+
ozfm	蹁	*+
ozfn	嘴	 +
ozfs	跞	*+
ozfu	躞	*+
ozg 	蹴	*+
ozgb	踯	*+
ozgg	趼	*+
ozgn	跃	*+
ozgq	踵	*+
ozgw	跹	*+
ozhb	迹	 +
oziu	躞	*+
ozj 	囝	*+
ozjd	蹬	*+
ozk 	践	*+
ozk 	趼	*+
ozkb	踬	*+
ozl 	吼	*+
ozla	蹰	*+
ozlf	迹	 +
ozli	蹶	*+
ozlk	蹴	 +
ozln	蹄	*+
ozlo	跖	*+
ozlo	踮	*+
ozlo	踣	*+
ozlt	躁	*+
ozlu	踱	*+
ozlx	跤	*+
ozly	躔	*+
ozm 	跚	*+
ozm 	踩	*+
ozmq	蹯	*+
ozmt	蹂	*+
ozmz	踪	 +
ozn 	足	*+
ozn 	跑	 +
ozn 	噱	*+
ozna	趵	*+
oznc	蹿	*+
ozne	跚	 +
oznf	跎	*+
oznl	跑	 +
oznp	跪	*+
oznr	跚	 +
ozns	踪	 +
ozns	蹿	 +
ozoo	局	 +
ozot	躁	*+
ozp 	跛	*+
ozpa	跗	*+
ozpd	跃	*+
ozpf	鹭	*+
ozpo	路	 +
ozpt	跞	*+
ozpu	踽	*+
ozpu	趿	 +
ozq 	跸	*+
ozqn	趺	*+
ozqq	跸	 +
ozqr	跷	*+
ozqt	踝	*+
ozr 	跳	*+
ozr 	唬	 +
ozr 	跞	*+
ozrb	跳	 +
ozrb	蹒	*+
ozrd	躇	*+
ozrn	趿	*+
ozrr	蹑	*+
ozrt	跺	*+
ozru	蹑	*+
ozrv	唬	 +
ozrv	躏	*+
ozs 	躐	*+
ozsb	躜	*+
ozsn	跌	 +
ozsr	跣	*+
ozss	躐	 +
ozst	蹀	*+
ozt 	踊	*+
oztd	踊	 +
oztq	踊	 +
ozu 	啃	*+
ozu 	啮	*+
ozuo	跆	*+
ozv 	蹼	*+
ozvo	踟	*+
ozw 	噬	*+
ozwd	踏	*+
ozwh	跻	*+
ozwr	跻	*+
ozwt	跞	*+
ozx 	跨	*+
ozya	踌	*+
ozyr	跷	*+
ozyy	跬	*+
ozz 	趾	*+
ozzj	踔	*+
o,  	お	*+
o,  	ぉ	*+
o,  	を	*+
o.  	オ	*+
o.  	ォ	*+
o.  	ヲ	*+
p   	自	*+
pa  	卜	*+
paa 	付	*+
paa 	卪	*+
pac 	俭	*+
pad 	伏	*+
pad 	侩	 +
pad 	臭	*+
pado	伧	 +
pae 	俭	*+
pae 	鐾	*+
pai 	偷	*+
paja	傅	 +
pajw	俅	 +
pak 	住	*+
pak 	优	 +
pal 	他	*+
pam 	伦	*+
pan 	俟	*+
paob	俭	 +
pap 	伶	*+
paq 	伐	*+
paqd	侩	 +
paqy	垡	*+
pase	俭	 +
pat 	伶	*+
paur	偷	 +
pav 	低	*+
pax 	代	*+
pax 	仪	 +
paxb	贷	 +
paxe	岱	*+
paxf	黛	*+
paxk	袋	*+
paxs	牮	*+
paz 	乏	*+
pa, 	ぱ	*+
pa. 	パ	*+
pb  	货	*+
pba 	冬	*+
pba 	处	 +
pba 	乊	*+
pbbo	俗	 +
pbcc	螽	*+
pbd 	份	*+
pbd 	昝	*+
pbe 	冬	*+
pben	师	 +
pbf 	伦	*+
pbh 	佯	*+
pbi 	郅	*+
pbj 	伴	*+
pbj 	阜	*+
pbk 	并	*+
pbki	仪	 +
pbl 	仳	*+
pbn 	处	*+
pbn 	帅	 +
pbnl	倦	 +
pbnp	倦	 +
pbo 	僧	*+
pbo 	咎	 +
pbp 	伧	*+
pbp 	乊	*
pbpd	偕	*+
pbqd	僧	 +
pbr 	价	*+
pbt 	侩	*+
pbu 	佾	*+
pbv 	傧	*+
pbw 	追	*+
pbwf	伪	 +
pbx 	仪	*+
pbze	归	 +
pbzn	归	 +
pc  	使	*+
pcc 	侈	*+
pcee	倔	*+
pceu	倔	*+
pcf 	伲	*+
pci 	仲	*+
pcj 	仲	*+
pcj 	伡	*+
pcjo	倨	*+
pcm 	僳	*+
pcmb	价	 +
pcnb	尽	 +
pcnu	禹	*+
pco 	价	*+
pcol	僻	 +
pcra	兔	*+
pcst	杰	 +
pct 	傈	*+
pct 	杰	 +
pcua	传	 +
pcyo	局	 +
pd  	候	*+
pda 	仞	*+
pdbs	僚	 +
pdc 	皂	*+
pdc 	蚕	 +
pdd 	倡	*+
pdde	翱	*+
pddj	皋	*+
pde 	但	*+
pde 	岙	 +
pded	皑	*+
pdel	皑	*+
pdf 	皂	*+
pdf 	忝	 +
pdfe	暨	 +
pdfj	皋	*+
pdfk	既	 +
pdfp	敫	*+
pdfr	兜	*+
pdfw	邀	 +
pdh 	忝	*+
pdil	俺	 +
pdje	翱	*+
pdjf	皋	*+
pdk 	皇	*+
pdkw	遑	*+
pdl 	偈	*+
pdlu	皈	*+
pdlx	皎	*+
pdmq	皤	*+
pdn 	帛	*+
pdn 	夭	*+
pdna	的	 +
pdnh	殷	*+
pdnl	偈	 +
pdnr	皖	*+
pdns	绵	 +
pdnu	殷	*+
pdo 	白	*+
pdo 	吞	 +
pdo 	伽	*+
pdoo	乔	 +
pdp 	劈	*+
pdpu	魄	 +
pdql	俺	 +
pdr 	例	*+
pdr 	乔	 +
pdr 	貌	 +
pdre	翱	*+
pdrk	侉	 +
pdso	皓	*+
pdte	翱	*+
pdte	皋	 +
pdto	倚	 +
pdv 	魄	*+
pdw 	迫	*+
pdw 	泉	 +
pdwe	翱	*+
pdwj	皋	*+
pdwt	乐	 +
pdx 	务	*+
pdx 	仂	*+
pdy 	务	*+
pdy 	仂	*+
pdyh	殷	*+
pdyu	殷	*+
pe  	至	*+
peb 	俩	*+
pedo	侨	 +
pee 	卫	*+
peem	戮	 +
peff	尽	 +
pei 	仙	*+
pek 	伥	*+
pem 	戮	*+
penb	俩	 +
penu	侵	 +
peo 	伺	*+
peqe	僵	*+
pes 	系	 +
pev 	催	*+
pew 	健	*+
pewf	伪	 +
pex 	伊	*+
pez 	俘	*+
pe, 	ぺ	*+
pe. 	ペ	*+
pf  	作	*+
pfa 	俦	*+
pfaq	牖	 +
pfb 	衅	*+
pfb 	仆	 +
pfc 	罗	*+
pfdg	偃	*+
pfe 	血	*+
pfe 	衄	*+
pfed	仆	 +
pfek	儇	 +
pffk	侬	 +
pfi 	牖	*+
pfj 	华	 +
pfl 	化	*+
pfm 	偏	*+
pfmb	货	 +
pfmk	众	 +
pfn 	伙	*+
pfnh	臻	*+
pfnq	俸	*+
pfnw	傣	*+
pfoo	伛	 +
pfp 	仰	*+
pfp 	仿	 +
pfp 	恤	 +
pfp 	佧	*+
pfpb	众	 +
pfq 	众	*+
pfsu	茳	*+
pfsv	罗	 +
pft 	倾	*+
pftb	倾	 +
pfv 	雇	*+
pfvd	侯	 +
pfw 	逢	*+
pfx 	伛	*+
pfy 	仿	*+
pfy 	睾	 +
pfyg	睾	 +
pg  	牌	*+
pgb 	郫	*+
pgi 	侨	*+
pgj 	仟	*+
pgj 	卑	 +
pgn 	侠	*+
pgnf	鹎	*+
pgno	侨	 +
pgnr	侨	 +
pgo 	侨	*+
pgr 	倪	*+
pgv 	俾	*+
pgx 	嬖	*+
pgy 	傍	*+
ph  	您	*+
ph  	悠	*+
pha 	息	*+
pha 	惫	 +
phg 	倭	*+
phj 	擘	*+
phmb	债	 +
phnp	傲	*+
phr 	俐	*+
phu 	倩	*+
phv 	悠	*+
phx 	俊	*+
pi  	信	*+
pi  	片	 +
pia 	傅	*+
pifd	候	 +
pih 	储	*+
pii 	伸	*+
pio 	信	 +
pio 	譬	 +
pip 	攸	*+
pip 	条	 +
pipd	倏	*+
piph	悠	 +
pipm	修	 +
pips	绦	 +
pipt	条	 +
pipu	修	 +
piqi	伸	 +
piqk	俜	*+
piv 	片	 +
pix 	俄	*+
piyd	储	 +
pi, 	ぴ	*+
pi. 	ピ	*+
pj  	平	*+
pj  	辟	*+
pj  	帛	*+
pja 	偾	*+
pja 	傺	*+
pjac	傤	*+
pjc 	使	 +
pjcx	使	 +
pje 	值	*+
pjj 	什	*+
pjl 	值	*+
pjm 	牍	*+
pjme	值	 +
pjml	值	 +
pjo 	估	*+
pjop	做	 +
pjqa	传	 +
pjrb	偾	 +
pjrs	傺	*+
pju 	伎	*+
pjx 	做	*+
pjyd	牍	 +
pk  	优	*+
pka 	璧	*+
pke 	任	*+
pkh 	恁	*+
pkkd	僭	*+
pkl 	仇	*+
pkmb	赁	*+
pkr 	凭	*+
pkt 	偿	*+
pkv 	粤	 +
pkx 	仇	*+
pkz 	仇	*+
pl  	卷	*+
pla 	僚	*+
pla 	俪	*+
pldh	亿	 +
ple 	位	*+
pleq	佣	 +
plht	停	 +
plk 	依	*+
plk 	襞	*+
pllb	俪	*+
plnf	傍	 +
plnt	停	 +
plo 	倍	*+
plok	僦	*+
plot	停	 +
plpa	俯	*+
plq 	僮	*+
plr 	伉	*+
plsk	僦	*+
plu 	版	 +
plx 	佼	*+
plxp	效	 +
pm  	们	*+
pm  	侮	*+
pmad	臭	*+
pmbr	侧	 +
pmde	翱	*+
pmeb	俱	 +
pmg 	偻	*+
pmh 	息	*+
pmi 	们	 +
pmnw	边	 +
pmo 	自	 +
pmqe	齄	*+
pmqg	鼾	*+
pmqk	鼽	*+
pmqr	鼻	 +
pmqr	劓	 +
pmr 	伣	*+
pmre	翱	*+
pmt 	臬	*+
pmte	翱	*+
pmv 	侮	*+
pmwe	翱	*+
pmy 	们	 +
pn  	条	*+
pna 	俅	*+
pnb 	倌	*+
pnbb	傧	 +
pnbi	倥	*+
pnbi	儋	 +
pncb	傧	 +
pncq	像	 +
pne 	伫	*+
pned	奥	*+
pnek	粤	 +
pneo	侗	*+
pneq	家	 +
pnf 	佗	*+
pni 	币	*+
pnj 	币	*+
pnk 	侬	*+
pnkb	傧	 +
pnl 	疱	*+
pnli	儋	*+
pnmd	奥	*+
pnmk	粤	 +
pnn 	像	 +
pno 	向	*+
pno 	佝	*+
pno 	倜	*+
pnol	疱	 +
pnpb	傧	 +
pnq 	佣	*+
pnqh	偬	*+
pnri	倥	*+
pns 	你	*+
pnsb	傧	 +
pnsh	您	 +
pnt 	伫	*+
pnv 	佩	*+
pnx 	儆	*+
pnyo	倜	*+
po  	譬	*+
poa 	乓	*+
poa 	俭	 +
pob 	邱	*+
pob 	兵	 +
pobb	兴	 +
poc 	囱	*+
poe 	岳	*+
poe 	丘	 +
poeb	奥	*+
poed	俣	*+
poek	粤	 +
pofu	假	 +
pogn	俣	*+
pojo	个	 +
pokd	俣	*+
pomb	奥	*+
pomk	粤	 +
pon 	儇	*+
pono	局	 +
poo 	各	 +
poo 	侣	 +
poop	俨	*+
pop 	乒	*+
pop 	俨	*+
popo	侣	 +
poq 	囱	*+
pos 	侃	*+
pot 	保	*+
potf	煲	*+
poty	堡	*+
pov 	侣	*+
pov 	雒	 +
pox 	假	*+
pox 	俨	*+
pox 	囟	*+
poz 	促	 +
po, 	ぽ	*+
po. 	ポ	*+
pp  	修	*+
pp  	傻	*+
ppa 	仆	*+
ppa 	处	 +
ppb 	佟	*+
ppbd	咱	 +
ppd 	伯	*+
ppd 	昝	*+
ppdo	侨	 +
ppdr	侨	 +
ppe 	侄	*+
ppg 	牌	 +
ppg 	俾	 +
ppj 	僻	*+
ppl 	倦	*+
ppo 	咎	*+
ppop	傻	 +
pppd	咱	 +
ppq 	备	*+
ppqg	牌	 +
ppqg	俾	 +
ppqu	傀	 +
ppr 	倒	*+
pps 	系	 +
ppu 	汲	*+
ppu 	仫	*+
ppv 	傻	*+
ppx 	致	*+
pq  	像	*+
pq  	佃	*+
pqa 	传	*+
pqe 	俚	*+
pqee	齄	*+
pqeg	鼾	*+
pqek	鼽	*+
pqer	鼻	 +
pqer	侥	 +
pqer	劓	 +
pqg 	卑	*+
pqgb	郫	 +
pqgf	鹎	*+
pqh 	惫	*+
pqj 	倬	*+
pqk 	偎	*+
pqn 	夫	*+
pqnu	偶	 +
pqo 	备	*+
pqo 	佃	 +
pqqq	儡	*+
pqr 	鼻	*+
pqra	魃	*+
pqrb	魉	 +
pqrd	魁	 +
pqre	齄	*+
pqrf	魍	*+
pqrg	鼾	*+
pqrk	鼽	*+
pqrl	魑	 +
pqrr	劓	*+
pqrs	魅	 +
pqrt	魅	 +
pqru	鬼	 +
pqru	魑	 +
pqru	魃	 +
pqru	魈	 +
pqt 	倮	*+
pqx 	仗	*+
pr  	侧	*+
pra 	佻	*+
prb 	供	*+
prbb	佻	 +
prc 	仅	 +
prcv	傩	*+
prd 	借	*+
pre 	仁	*+
pren	佩	 +
prg 	佞	*+
pri 	到	*+
prj 	佴	*+
prl 	仉	*+
prl 	处	 +
prl 	凡	 +
prlh	惫	 +
prlq	备	 +
prn 	汲	*+
prnp	儆	 +
pro 	偌	*+
prok	侬	 +
prp 	仍	*+
prph	惫	 +
prpq	备	 +
prre	翱	*+
prss	俳	*+
prtn	佩	 +
prx 	侵	*+
prxo	偌	 +
prz 	仉	*+
prz 	处	 +
prz 	凡	 +
ps  	系	*+
psa 	系	 +
psb 	侏	*+
pse 	仨	*+
psj 	件	*+
psn 	佚	*+
psnb	偿	 +
psnf	傥	*+
psno	倘	*+
psnq	当	 +
psnr	傥	*+
psnt	偿	 +
pso 	当	 +
pss 	侏	*+
pst 	牒	*+
psu 	俏	*+
psw 	逄	*+
pt  	休	*+
pt  	停	*+
pta 	颇	*+
ptd 	佰	*+
ptdp	优	 +
pte 	体	*+
pti 	仃	*+
ptj 	俑	*+
ptmb	颇	 +
ptmp	优	 +
ptn 	条	 +
ptn 	休	 +
ptn 	檗	*+
ptn 	臬	 +
ptnb	俩	 +
ptnf	鸺	*+
ptnq	俑	 +
pto 	何	*+
ptqx	便	 +
pttk	侬	 +
ptv 	停	*+
ptx 	便	*+
pu  	仅	*+
pu  	偶	*+
pua 	么	*+
pua 	似	 +
pua 	麽	*+
pub 	似	*+
pubp	俊	 +
pue 	臂	*+
pun 	似	*+
pur 	儒	*+
purp	俊	 +
pus 	侔	*+
putr	儒	 +
puv 	偶	*+
puv 	傩	*+
puvd	俟	 +
puwf	伪	 +
pux 	及	*+
pux 	仅	 +
pu, 	ぷ	*+
pu. 	プ	*+
pv  	泉	*+
pva 	傀	*+
pvd 	伤	*+
pvdm	伤	 +
pve 	伤	*+
pvf 	作	 +
pvf 	僬	*+
pvj 	佛	*+
pvn 	仆	*+
pvo 	倚	*+
pvo 	儋	*+
pvom	侮	 +
pvx 	使	 +
pvz 	仡	*+
pw  	邀	*+
pwa 	伪	*+
pwa 	佤	*+
pwa 	甓	*+
pwe 	伍	*+
pwh 	侪	*+
pwj 	伟	*+
pwj 	仵	*+
pwje	翱	*+
pwn 	避	*+
pwo 	俗	*+
pwos	伟	 +
pwr 	侪	*+
pwre	翱	*+
pwul	胤	*+
px  	皮	*+
px  	仪	*+
pxa 	传	*+
pxa 	低	 +
pxbd	牍	 +
pxe 	低	*+
pxe 	侑	 +
pxfp	傻	 +
pxi 	佐	*+
pxk 	侉	*+
pxl 	俺	*+
pxn 	布	*+
pxo 	佑	*+
pxp 	伢	*+
pxu 	侑	*+
pxup	傻	 +
pxv 	仪	*+
py  	片	*+
py  	仕	*+
pya 	侍	*+
pybg	幸	 +
pydo	僖	*+
pye 	壁	 +
pye 	仕	 +
pyeo	伺	 +
pyfb	牍	 +
pyfp	傲	*+
pyj 	幸	 +
pym 	牍	*+
pyo 	佶	*+
pyoo	僖	*+
pyp 	伢	*+
pypf	佬	*+
pyr 	侥	*+
pyv 	仕	*+
pyx 	优	 +
pyy 	佳	 +
pyya	俦	 +
pyyr	侥	 +
pz  	促	*+
pzdj	倬	 +
pzj 	仔	*+
pzl 	亿	*+
pzmb	侦	 +
pzn 	乏	*+
pzo 	占	*+
pzw 	延	*+
pzz 	亿	*+
q   	个	*+
q   	高	*+
qa  	贵	*+
qaa 	专	 +
qad 	畎	*+
qad 	狯	 +
qadf	默	 +
qadk	狼	 +
qae 	猃	*+
qak 	犹	*+
qal 	弛	*+
qamr	规	 +
qan 	狼	*+
qaob	猃	 +
qaqc	辇	*+
qaqd	替	 +
qaqd	狯	 +
qaqj	狨	*+
qaqx	狨	*+
qase	猃	 +
qat 	狳	*+
qb  	弱	*+
qbe 	犹	*+
qbgo	猞	 +
qbh 	狳	*+
qbj 	畔	*+
qbl 	毗	*+
qbm 	畛	*+
qbn 	未	*+
qbn 	末	 +
qbo 	猞	*+
qbpg	嫠	*+
qbpq	厘	*+
qbps	犁	 +
qbqb	弱	 +
qbqj	弹	 +
qbr 	界	 +
qbt 	狯	*+
qby 	狴	*+
qc  	独	*+
qca 	独	 +
qcm 	猸	*+
qd  	替	*+
qd  	狱	*+
qdbs	獠	 +
qdd 	猖	*+
qdgd	嬲	*+
qdk 	狠	*+
qds 	猩	*+
qdto	畸	 +
qdto	猗	 +
qdv 	狱	*+
qdx 	男	*+
qdy 	男	*+
qe  	里	*+
qee 	狰	*+
qee 	狃	*+
qeev	狃	*+
qei 	击	 +
qek 	张	*+
qeot	鬶	*
qeqe	彊	*+
qeqe	强	 +
qer 	尧	*+
qer 	畀	*+
qere	翘	*+
qesi	弪	 +
qf  	默	*+
qfa 	黑	*+
qfa 	畴	*+
qfad	默	 +
qfay	黔	*+
qfc 	猡	*+
qfcc	黟	*+
qfee	黜	*+
qfeu	黜	*+
qfh 	黢	*+
qfjd	黩	*+
qfjm	黩	*+
qfld	黯	*+
qfls	黥	*+
qfn 	狄	*+
qfnc	独	 +
qfsv	猡	 +
qfu 	猢	*+
qfum	黪	*+
qfup	黢	 +
qfw 	逖	*+
qfwd	黝	*+
qfy 	墨	*+
qfyb	黩	*+
qfym	黩	*+
qfyo	黠	*+
qfzo	点	 +
qg  	弧	*+
qga 	狐	*+
qga 	弧	 +
qgj 	犴	*+
qgn 	狭	*+
qgn 	狐	 +
qgn 	弧	 +
qgqf	獯	*+
qgr 	猊	*+
qh  	愚	*+
qha 	思	*+
qho 	猪	*+
qhr 	猁	*+
qhu 	猜	*+
qhx 	狻	*+
qi  	甲	*+
qiad	狱	 +
qii 	引	*+
qii 	甲	 +
qij 	吊	*+
qin 	歉	*+
qinf	鸭	*+
qio 	狺	*+
qj  	弹	*+
qj  	卓	*+
qjcb	獭	*+
qjj 	猝	*+
qjjq	毕	 +
qjou	猢	 +
qju 	敲	*+
qjv 	卓	*+
qk  	弓	*+
qke 	狂	*+
qkl 	犰	*+
qkn 	畏	*+
qkw 	逛	*+
qkx 	犰	*+
qkz 	犰	*+
ql  	规	*+
qla 	獠	*+
qlbi	獗	*+
qldj	獐	*+
qldr	獍	*+
qlk 	犷	*+
qlp 	犷	*+
qlq 	疃	*+
qlrb	犷	 +
qlu 	畈	*+
qlw 	弦	*+
qlx 	狡	*+
qm  	滚	*+
qmb 	狈	*+
qme 	狙	*+
qmf 	犸	*+
qmq 	粥	*+
qmqm	弱	 +
qmqt	鬻	*+
qmt 	猱	*+
qmv 	叠	*+
qn  	兼	*+
qna 	狩	*+
qncp	畹	*+
qnds	獬	*+
qne 	狰	*+
qnf 	鹣	*+
qnfl	狍	 +
qnht	狞	 +
qnl 	狍	*+
qnm 	叠	*+
qnmr	规	 +
qnmt	椝	*+
qnmt	鬶	 +
qnn 	夫	*+
qno 	狗	*+
qnol	狍	 +
qnqc	辇	*+
qnqd	替	 +
qns 	弥	*+
qns 	狝	*+
qnt 	狞	*+
qnu 	禺	*+
qnub	颙	*+
qnuh	愚	 +
qnut	颙	*
qnuw	遇	 +
qnv 	狮	*+
qo  	田	*+
qoa 	猃	*+
qoc 	强	*+
qocs	犟	*+
qoj 	弹	 +
qoo 	呙	*+
qooj	弹	 +
qor 	剐	*+
qou 	狷	*+
qow 	过	*+
qp  	犯	*+
qpbn	狮	 +
qpfd	猴	*+
qpl 	犯	 +
qpo 	略	*+
qpx 	畋	*+
qq  	各	*+
qqe 	狸	*+
qqi 	狎	*+
qqk 	猥	*+
qqns	猕	*+
qqqm	叠	 +
qqqy	垒	*+
qqt 	猓	*+
qqu 	猾	*+
qqu 	猬	*+
qqvs	猕	*+
qr  	界	*+
qrb 	异	*+
qrd 	猎	*+
qre 	獾	*+
qren	狮	 +
qrj 	毕	*+
qrj 	弭	*+
qrov	獾	 +
qrq 	猫	*+
qrv 	脏	*+
qrvu	获	 +
qrx 	弥	*+
qs  	罪	*+
qsa 	累	*+
qsfs	猎	 +
qsi 	弪	*+
qsl 	猎	*+
qsos	猎	 +
qsrq	猎	 +
qt  	颗	*+
qtcc	夥	*+
qtde	猹	 +
qtdq	弼	*+
qti 	町	*+
qtm 	猹	*+
qtn 	果	*+
qtn 	椝	*
qtt 	颗	 +
qttb	颗	 +
qu  	击	*+
qu  	胃	*+
qua 	弘	*+
qua 	骺	*+
qubp	狻	 +
qubr	骱	*+
quc 	强	*+
quca	骶	*+
qucs	犟	*+
que 	骨	*+
que 	胃	 +
que 	膏	 +
qufc	髑	*+
qufd	体	 +
qufo	骺	*+
qui 	野	*+
qui 	击	 +
qui 	弪	 +
qui 	骺	*+
qujo	骷	*+
qulh	骸	*+
qulr	肮	 +
qumg	髅	*+
quna	髋	*+
qunb	髌	*+
qunf	鹘	*+
quno	髂	*+
qunr	髋	*+
qupg	髀	*+
qupo	骼	*+
quqt	髁	*+
qur 	狁	*+
qurd	体	 +
qurp	狻	 +
qurr	脏	 +
quru	骰	*+
quv 	胃	*+
qux 	髓	*+
quxa	骶	*+
quxe	骶	*+
quxw	髓	 +
quy 	墅	*+
quy 	弪	 +
qv  	高	*+
qvj 	狒	*+
qvo 	畸	*+
qvo 	猗	*+
qvs 	弥	*+
qvs 	狝	*
qvsb	獭	*+
qw  	遇	*+
qwn 	遗	*+
qwv 	髓	*+
qx  	丈	*+
qxx 	曳	*+
qy  	酬	*+
qyd 	猪	*+
qyee	疆	*+
qyen	狮	 +
qyof	黠	*+
qyok	猿	*+
qypd	猪	 +
qypt	橥	*+
qyy 	畦	*+
qyya	畴	*+
qz  	跟	*+
qzf 	猛	*+
qzof	点	 +
qzs 	狲	*+
qzu 	敲	*+
r   	二	*+
ra  	兆	*+
ra  	耐	*+
ra  	巜	*+
raa 	凡	*+
raa 	耐	 +
racc	虱	 +
rad 	荟	*+
radk	莨	 +
rado	苍	 +
radr	莽	 +
rae 	鉴	*+
rae 	莶	 +
rajq	莆	 +
rakp	茏	 +
ral 	茏	*+
ran 	莨	*+
raob	莶	 +
raop	蔹	 +
rap 	聆	*+
rap 	苓	*+
rap 	蔹	 +
raqb	蒇	*+
raqd	荟	 +
raqg	葳	*+
raqp	茂	 +
raqr	藏	 +
rase	莶	 +
rasp	蔹	 +
rat 	聆	*+
rat 	苓	*+
rat 	荼	*+
rav 	耐	*+
raw 	迅	*+
rax 	茇	*+
raxf	茏	 +
raxu	茇	 +
raxx	茇	 +
ray 	芩	*+
raz 	芝	*+
ra, 	ら	*+
ra. 	ラ	*+
rb  	共	*+
rb  	贤	*+
rba 	共	 +
rbat	荫	 +
rbau	荫	 +
rbb 	兆	 +
rbb 	苁	*+
rbbu	鼗	*+
rbbu	荫	 +
rbbw	逃	 +
rbd 	芬	*+
rbe 	苤	*+
rbed	联	 +
rbef	蒹	*+
rbeu	蒴	*+
rbf 	恭	*+
rbfl	巷	 +
rbgn	联	 +
rbh 	恭	*+
rbh 	荼	*+
rbi 	耶	*+
rbi 	茨	 +
rbj 	荜	*+
rbk 	荃	*+
rbl 	芘	*+
rbll	萨	 +
rblp	萨	 +
rbls	萨	 +
rbn 	卧	*+
rboh	聪	*+
rboh	葱	 +
rbol	巷	 +
rbp 	苍	*+
rbp 	巷	 +
rbpd	蒈	*+
rbqk	蕲	*+
rbr 	芥	*+
rbrf	鹡	*
rbru	脊	 +
rbt 	茶	 +
rbt 	荟	 +
rbu 	荫	*+
rbue	蓊	*+
rbv 	贤	*+
rbwl	萨	 +
rbws	萨	 +
rbx 	蔽	*+
rc  	辈	*+
rca 	蔚	*+
rca 	茧	*+
rca 	风	 +
rcad	飙	*+
rcb 	鄞	*+
rcc 	靶	*+
rcc 	鞅	*+
rccl	靶	 +
rccw	千	 +
rcd 	勤	*+
rcd 	勒	 +
rcde	靼	*+
rcdj	蕈	 +
rcdk	艰	 +
rcdm	扬	 +
rcdw	鞑	*+
rce 	盖	*+
rce 	堇	*+
rce 	鞔	*+
rceb	蒉	 +
rceb	聩	 +
rcee	缰	*+
rcff	飚	*+
rcfr	葬	*+
rcg 	鞒	*+
rcgo	刮	 +
rcgo	鞒	 +
rcgr	鞒	 +
rcgu	飕	*+
rch 	蕙	*+
rchf	秋	 +
rci 	叹	*+
rciu	飕	*+
rcj 	革	*+
rcj 	鞲	*+
rcjy	鞲	*+
rck 	靳	*+
rcl 	芭	*+
rcmb	飓	*+
rcmr	觐	*+
rcmt	鞣	*+
rcn 	英	*+
rcn 	飑	 +
rcnb	荩	*+
rcng	鞍	*+
rcni	鞫	*+
rcnl	飑	 +
rcnm	鞠	*+
rcnr	鞔	*+
rco 	茜	*+
rco 	茗	*+
rcol	薜	*+
rcot	蘖	 +
rcp 	苑	*+
rcpf	靴	*+
rcpo	鞒	 +
rcpr	鞒	 +
rcpt	鞭	*+
rcpx	鞭	*+
rcra	蔚	 +
rcrq	鞴	*+
rcrz	鞯	*+
rcsu	鞘	*+
rcuh	蕙	 +
rcuo	台	 +
rcv 	难	*+
rcw 	莲	*+
rcyw	鞑	*+
rcyy	鞋	*+
rd  	获	*+
rd  	暮	*+
rda 	夙	*+
rda 	莳	*+
rdb 	苏	*+
rdca	菟	*+
rdd 	莫	*+
rdd 	菖	*+
rddd	募	*+
rddd	暮	 +
rddd	荔	*+
rddf	慕	*+
rddf	蓦	*+
rddh	摹	*+
rddh	慕	 +
rddn	幕	 +
rddy	墓	 +
rdfr	葬	*+
rdfu	蔓	 +
rdil	庵	 +
rdj 	草	*+
rdk 	茛	*+
rdl 	葛	*+
rdnf	鹊	*+
rdnl	葛	 +
rdo 	昔	*+
rdo 	茄	*+
rdo 	苕	*+
rdp 	聊	*+
rdp 	茆	*+
rdql	庵	 +
rdr 	莽	*+
rdre	薤	*+
rdrs	萘	*+
rdru	蕞	*+
rdu 	萌	*+
rdv 	暮	*+
rdw 	荙	*+
rdx 	劝	*+
rdy 	劝	*+
re  	臣	*+
rea 	荨	*+
recr	葬	*+
ree 	归	*+
ree 	茁	 +
reem	蓼	 +
reff	荩	*+
reg 	荽	*+
reh 	萧	*+
rei 	出	*+
reia	荨	 +
rek 	芜	*+
rek 	苌	*+
rem 	蓼	*+
ren 	师	*+
ren 	荑	*+
renb	颟	*+
renf	凤	 +
rent	颟	*+
rep 	茚	*+
reqb	黄	 +
reqe	姜	 +
reqr	藐	*+
reqs	蕤	*+
rers	萧	 +
resi	茎	 +
resr	萧	 +
ret 	菜	*+
reu 	茁	*+
reub	蕻	*+
revf	蘸	*+
rez 	莩	*+
rezf	蔫	*+
re, 	れ	*+
re. 	レ	*+
rf  	燕	*+
rfa 	鉴	*+
rfaa	蔑	*+
rfab	蔑	*+
rfae	蔑	*+
rfav	蔑	*+
rfbb	菸	*+
rfc 	萝	*+
rfd 	曹	*+
rfdd	葜	*+
rfdw	遭	 +
rfe 	监	*+
rff 	苣	*+
rfh 	薯	*+
rfka	蓐	*+
rfl 	芒	*+
rfl 	芑	*+
rflf	熙	*+
rfmb	荬	 +
rfmr	览	 +
rfn 	耿	*+
rfnc	梦	 +
rfnf	薨	*+
rfnh	蓁	*+
rfnm	瞢	*+
rfnw	甍	*+
rfof	燕	 +
rfp 	芦	*+
rfpr	蔸	*+
rfs 	荒	*+
rfsu	菽	*+
rfsv	萝	 +
rfu 	葫	*+
rfvd	蔟	*+
rfy 	芳	*+
rfyd	薯	 +
rg  	联	*+
rgb 	萸	*+
rgca	蒋	*+
rgea	蒋	*+
rgfa	薅	*+
rgfk	薅	*+
rgi 	荞	*+
rgi 	节	 +
rgj 	芊	*+
rgjo	菇	*+
rgl 	芜	*+
rgn 	联	 +
rgn 	荚	*+
rgnh	蓁	*+
rgno	荞	 +
rgnr	荞	 +
rgo 	茹	*+
rgo 	聒	*+
rgo 	苷	*+
rgo 	荞	 +
rgq 	董	*+
rgqf	薰	*+
rgua	蒋	*+
rgx 	耍	*+
rgy 	庄	*+
rgy 	蒡	*+
rh  	惹	*+
rh  	祥	*+
rha 	芯	*+
rha 	耻	 +
rha 	恧	*+
rha 	莳	*+
rhdd	葜	*+
rhdw	藜	*+
rhg 	萎	*+
rhhh	蕊	*+
rhmb	赜	*+
rho 	著	*+
rhr 	莉	*+
rhr 	莠	*+
rhu 	菁	*+
rhv 	祥	*+
ri  	而	*+
ri  	警	*+
ri  	巜	*
rid 	蔼	*+
ridl	蔼	 +
rif 	盗	*+
rig 	姿	*+
rih 	恣	*+
rih 	薯	 +
rii 	亍	*+
rij 	莆	*+
rimb	资	 +
rin 	次	*+
rin 	欢	 +
rin 	芡	*+
rio 	咨	*+
riqb	黄	 +
riqk	聘	 +
riv 	警	*+
rivu	护	 +
riw 	瓷	*+
rix 	莪	*+
riyd	薯	 +
riz 	荐	*+
ri, 	り	*+
ri. 	リ	*+
rj  	耳	*+
rj  	廾	*+
rja 	蔡	*+
rja 	菝	*+
rjau	菝	*+
rjax	菝	*+
rjbo	蔷	*+
rjci	蔌	*+
rjed	葵	 +
rjeg	萋	 +
rjfh	听	 +
rjg 	萋	*+
rjgn	葵	 +
rjj 	萃	*+
rjjq	华	 +
rjn 	芾	*+
rjnz	荸	*+
rjo 	苦	*+
rjou	葫	 +
rjqb	荑	*+
rjqh	蕙	 +
rjrs	蔡	 +
rju 	芰	*+
rjuq	萚	*+
rjv 	廾	*+
rjzt	艺	 +
rk  	考	*+
rk  	聘	*+
rka 	玺	*+
rka 	芄	 +
rkb 	萁	*+
rkbl	葚	*+
rki 	芹	*+
rkj 	听	 +
rkjh	听	 +
rkk 	亏	*+
rkl 	耽	*+
rkl 	葚	*+
rkl 	艽	 +
rklb	葚	*+
rklr	葚	*+
rkn 	葵	*+
rkr 	荆	*+
rkrl	葚	*+
rkv 	聘	*+
rkw 	莛	*+
rkx 	艽	*+
rkz 	艽	*+
rl  	儿	*+
rl  	几	 +
rla 	蓠	*+
rlad	职	 +
rlbd	蒺	*+
rlbi	蕨	*+
rld 	苈	*+
rldh	薏	*+
rldk	蓑	*+
rlho	蒿	*+
rlht	藁	*+
rli 	薪	*+
rlj 	莘	*+
rlkf	荐	 +
rln 	莱	*+
rln 	芾	 +
rlnf	蒡	*+
rlnn	蒂	*+
rlno	蒿	*+
rlnt	藁	*+
rlnt	葶	*+
rlo 	菩	*+
rloo	蒿	*+
rlot	藁	*+
rlot	葶	*+
rlp 	苊	*+
rlp 	苄	*+
rlqu	藕	*+
rlrd	藉	 +
rlrf	蔗	*+
rlrn	席	 +
rltk	薪	 +
rlto	蘑	*+
rlts	蘼	*+
rlul	茏	 +
rlwq	蓄	 +
rlwv	蕹	*+
rlx 	茭	*+
rlxu	蓠	 +
rm  	藏	*+
rma 	荬	*+
rmbr	荝	*+
rmcs	兰	 +
rmd 	鼐	*+
rme 	苴	*+
rmg 	蒌	*+
rmgp	薮	*+
rmii	荇	*+
rmii	蘅	*+
rmip	薇	*+
rmit	荇	*+
rmit	蘅	*+
rmiz	蓰	*+
rmiz	苁	 +
rmjs	兰	 +
rmn 	兰	*+
rmo 	苜	*+
rmp 	茅	*+
rmq 	蕃	*+
rmr 	览	 +
rmr 	苋	*+
rmr 	观	 +
rmv 	蔺	*+
rmx 	蔓	*+
rn  	幕	*+
rn  	营	 +
rna 	芍	*+
rna 	蓥	*+
rnaq	葡	 +
rnb 	菅	*+
rnb 	芮	*+
rnbb	颟	*+
rnbo	蓉	 +
rnbt	颟	*+
rnc 	萤	*+
rnc 	荤	*+
rnca	菟	*+
rncp	菀	*+
rnd 	劳	*+
rnd 	荀	*+
rne 	萱	*+
rne 	苎	*+
rnee	萱	 +
rneo	茼	*+
rneq	卜	 +
rnf 	荧	*+
rnf 	凤	 +
rnf 	鹳	*+
rnf 	茑	*+
rnf 	鸸	*+
rng 	萏	*+
rni 	葡	*+
rni 	萄	*+
rni 	帅	 +
rnj 	帅	*+
rnka	莹	*+
rnl 	苞	*+
rnlo	菪	*+
rnm 	菊	*+
rnm 	芴	*+
rnn 	及	*+
rnnf	莺	*+
rno 	苟	*+
rno 	苘	*+
rnof	惊	 +
rnoh	擎	 +
rnoi	警	 +
rnol	苞	 +
rnoo	营	 +
rnop	敬	 +
rnot	檠	*+
rnpd	蓿	*+
rnqh	葱	*+
rnr 	耽	*+
rnr 	苒	 +
rnrf	鹲	*+
rnrq	蒙	 +
rnrr	莞	*+
rnru	蔻	*+
rns 	萦	*+
rns 	荦	*+
rnsc	茧	*+
rnt 	荣	*+
rnt 	苎	*+
rnt 	聍	*+
rnv 	营	 +
rnw 	蓉	*+
rnw 	荥	*+
rnwu	萄	*+
rnx 	及	*+
rny 	苒	*+
rny 	聃	*+
rny 	茔	*+
rnz 	茕	*+
rnzo	萜	*+
ro  	落	*+
ro  	廿	*+
roa 	莶	*+
roar	蕺	*+
rob 	职	*+
rod 	茵	*+
rodh	蒽	*+
roff	燕	 +
rofu	葭	 +
roh 	菌	*+
roh 	惹	 +
rok 	圣	*+
rok 	萼	*+
rok 	蕲	*+
rolf	熙	*+
ronb	莴	*+
roo 	若	*+
roo 	莒	*+
roo 	茴	*+
roob	颧	*+
rood	劝	 +
roof	鹳	*+
rooi	欢	 +
rook	萼	*+
rook	蕲	 +
roor	观	 +
root	颧	*+
rop 	蔹	*+
ropo	莒	*+
ror 	葺	*+
ror 	曲	 +
rorb	酆	 +
rorb	典	 +
rorc	艳	 +
rord	曹	 +
rorf	艳	 +
rork	农	 +
rorl	艳	 +
rorq	蕺	*+
rorr	觍	*
rorw	遭	 +
rov 	廿	*+
rov 	莒	*+
rox 	葭	*+
rox 	苠	*+
ro, 	ろ	*+
ro. 	ロ	*+
rp  	乃	*+
rp  	茂	*+
rpa 	卧	*+
rpa 	聪	*+
rpa 	苻	*+
rpa 	葱	*+
rpad	茯	*+
rpbg	薛	*+
rpbl	薛	*+
rpbt	蘖	 +
rpbz	孽	*+
rpdc	葩	*+
rpdk	凰	*+
rpdl	葩	*+
rpdo	荞	 +
rpdr	荞	 +
rpdr	蔸	 +
rpdt	药	 +
rpf 	花	*+
rpfw	蓬	*+
rpg 	萆	*+
rpi 	节	*+
rpi 	苓	*+
rpip	莜	*+
rpj 	苹	*+
rpj 	薜	*+
rpk 	荏	*+
rpl 	莅	*+
rplo	蓓	*+
rpmp	夔	*+
rpob	蓖	*+
rpoh	聪	*+
rpoh	葱	 +
rpot	葆	*+
rpqg	萆	 +
rpqu	搜	 +
rpt 	蘖	*+
rpto	荷	*+
rpu 	芨	*+
rpv 	茂	*+
rpy 	茌	*+
rq  	福	*+
rq  	蒙	*+
rqa 	蒉	*+
rqa 	聩	*+
rqad	获	 +
rqak	莸	*+
rqb 	黄	 +
rqb 	茉	 +
rqer	荛	 +
rqf 	荻	*+
rqh 	葸	*+
rqj 	荜	*+
rqj 	芈	 +
rqjq	荜	 +
rqk 	芎	*+
rqk 	聘	 +
rqn 	芙	*+
rqn 	蒹	*+
rqnf	鹋	*+
rqnu	万	 +
rqnw	迈	 +
rqnz	趸	 +
rqo 	苗	*+
rqo 	蒿	*+
rqo 	莴	*+
rqt 	果	*+
rqt 	藁	*+
rqv 	蒙	*+
rqy 	芎	*+
rr  	视	*+
rr  	藏	 +
rre 	亖	*+
rrf 	蓝	*+
rri 	茨	*+
rri 	亓	*+
rrj 	茸	*+
rrj 	华	 +
rrl 	元	*+
rrn 	药	 +
rrn 	芨	 +
rrol	鼋	*+
rrp 	艿	*+
rrq 	华	 +
rrr 	聂	*+
rrr 	芫	*+
rrrb	颞	*+
rrrt	颞	*+
rrse	韭	*+
rrss	菲	*+
rrss	蒜	*+
rrt 	顽	*+
rrtb	顽	 +
rru 	芟	*+
rruo	兘	*+
rrv 	藏	 +
rrvf	蓝	 +
rrw 	远	*+
rs  	非	*+
rs  	蔬	*+
rsa 	示	*+
rsa 	荮	*+
rsa 	尕	*+
rsa 	祓	*+
rsau	祓	*+
rsax	祓	*+
rsb 	祁	*+
rsb 	茱	*+
rsbf	禚	*+
rsbh	祥	 +
rsbj	禅	 +
rscw	禄	*+
rsdf	蕴	*+
rse 	祠	*+
rse 	莼	*+
rseq	福	 +
rsew	禄	*+
rsfa	祷	*+
rsfd	礼	 +
rsfd	禊	 +
rsgn	祆	*+
rshd	禊	*+
rshp	秘	 +
rsi 	神	*+
rsi 	茎	 +
rsi 	荭	*+
rsii	神	 +
rsjo	祜	*+
rsk 	祈	*+
rskb	祺	*+
rsl 	礼	*+
rsl 	禳	 +
rslk	禳	 +
rsm 	祖	*+
rsmf	祃	*+
rsmr	视	 +
rsna	药	 +
rsnp	蔽	 +
rsns	祢	*+
rso 	禅	*+
rsob	祸	*+
rsof	蕴	*+
rsoj	禅	 +
rsol	祀	*+
rsor	祝	*+
rspd	祆	*+
rsqk	蕲	*+
rsqo	祸	*+
rsr 	祧	*+
rsrb	祧	 +
rsrd	礼	 +
rss 	非	 +
rss 	茱	*+
rssc	辈	 +
rssc	蜚	*+
rsse	韭	*+
rsse	翡	*+
rssh	悲	 +
rssk	裴	*+
rssw	斐	*+
rst 	叶	*+
rsv 	蔬	*+
rsvf	祚	*+
rsvs	祢	*+
rsw 	祎	*+
rsx 	只	*+
rsxa	祗	*+
rsxe	祗	*+
rsxo	佑	 +
rsy 	社	*+
rsya	祷	*+
rsyo	祠	 +
rsyo	禧	*+
rsyu	祛	*+
rsz 	祉	*+
rszb	祯	*+
rt  	茶	*+
rta 	芸	*+
rta 	颐	*+
rta 	颧	*+
rta 	苓	*+
rtbu	菘	*+
rte 	苯	*+
rte 	薹	*+
rti 	耵	*+
rtk 	菥	*+
rtl 	茺	*+
rtm 	葙	*+
rtmb	颐	*+
rtmb	颧	 +
rtn 	朵	*+
rtn 	师	 +
rto 	苛	*+
rtqb	黄	 +
rtr 	剁	*+
rtr 	茺	 +
ru  	凤	*+
rua 	云	 +
rub 	苡	*+
rubb	菸	*+
rubw	藤	*+
rud 	竖	*+
rudm	参	 +
ruf 	盈	*+
rufh	苏	 +
rufh	藓	*+
rufq	戤	*+
rufr	蓟	*+
rug 	娶	*+
rui 	茎	*+
ruj 	芋	*+
rul 	竖	*+
rumb	贤	 +
rumb	鄹	 +
rumk	聚	 +
ruo 	凸	*+
ruo 	苔	*+
rup 	散	 +
rupb	聚	 +
rupb	鄹	 +
rupu	菔	*+
ruq 	聚	*+
ruq 	蕾	*+
ruqb	鄹	*+
ruqr	藐	*+
rur 	薷	*+
rus 	紧	*+
rut 	蓣	*+
rutb	蓣	 +
rutr	薷	 +
ruu 	肾	*+
ruu 	聂	 +
ruub	颞	*+
ruum	参	 +
ruur	蒯	*+
ruut	颞	*+
ruv 	藿	*+
rux 	取	*+
rux 	凤	 +
rux 	殳	 +
ruy 	坚	*+
ruy 	茎	 +
ru, 	る	*+
ru. 	ル	*+
rv  	临	*+
rva 	搜	*+
rvaa	鉴	 +
rvac	临	 +
rvaf	监	 +
rvar	览	 +
rvc 	临	 +
rve 	萑	*+
rvea	鉴	 +
rvec	临	 +
rvef	监	 +
rver	览	 +
rvf 	蕉	*+
rvff	芜	 +
rvg 	旧	*+
rvoc	临	 +
rvom	莓	*+
rvoo	临	 +
rvos	蘩	 +
rvs 	蘩	*+
rvsi	蔌	*+
rvur	劐	*+
rvzf	盐	 +
rw  	遭	*+
rwa 	蒗	*+
rwaa	薄	 +
rwab	芗	 +
rwak	蒗	 +
rwaq	蒲	 +
rwbp	菱	 +
rwbu	菡	 +
rwdb	芗	 +
rwdm	荡	 +
rwe 	荡	*+
rwef	蒸	*+
rwf 	茫	*+
rwfl	范	 +
rwft	蕖	*+
rwh 	荠	*+
rwi 	蒲	*+
rwi 	茳	*+
rwia	薄	 +
rwj 	苇	*+
rwlk	蒎	*+
rwlt	藻	*+
rwm 	菹	*+
rwmq	藩	*+
rwn 	逃	*+
rwn 	迩	 +
rwoo	蔷	*+
rwos	苇	 +
rwot	藻	*+
rwp 	范	*+
rwp 	萍	*+
rwp 	菠	*+
rwp 	芗	 +
rwpl	莅	 +
rwpo	落	 +
rwpt	药	 +
rwr 	荠	*+
rws 	莎	*+
rwto	菏	*+
rwu 	菡	*+
rwu 	胤	*+
rwuu	蓠	 +
rww 	兹	*+
rwwf	联	 +
rwwf	鹚	 +
rwwh	慈	 +
rwwm	荡	 +
rwwz	孳	*+
rwy 	菱	*+
rwyp	菱	 +
rx  	散	*+
rx  	尔	*+
rxad	飙	*+
rxdq	飗	*+
rxem	飏	*
rxff	飚	*+
rxgu	飕	*+
rxi 	芗	*+
rxiu	飕	*+
rxiy	茬	*+
rxiz	荐	 +
rxj 	蕈	*+
rxl 	庵	*+
rxmb	飓	*+
rxn 	飑	*+
rxnl	飑	 +
rxo 	若	*+
rxoh	惹	 +
rxoq	飗	*
rxp 	芽	*+
rxqh	飔	*+
rxuo	台	 +
rxv 	艾	*+
rxvm	飏	*
rxwm	飏	*
rxx 	风	*+
rxx 	艾	 +
rxx 	芪	*+
rxym	飏	*+
rxzo	飐	*+
ry  	墓	*+
rybd	荬	 +
rybp	菱	 +
rybt	艺	 +
ryd 	著	*+
rydu	鼗	*+
rye 	芏	*+
ryi 	莰	*+
rykt	艺	 +
ryl 	蔬	*+
ryop	薹	*+
ryou	鼗	*+
ryp 	芽	*+
rypd	著	 +
rypd	着	 +
rypd	蓍	*+
ryr 	荛	*+
ryrp	菱	 +
ryrt	艺	 +
rys 	茉	*+
ryuf	盖	 +
ryx 	菱	*+
ryya	葑	*+
ryyr	荛	 +
ryzs	蔬	 +
ryzt	艺	 +
rz  	几	*+
rz  	荐	*+
rza 	芄	*+
rze 	耻	*+
rze 	芷	*+
rzen	归	 +
rzes	荪	 +
rzew	蘧	 +
rzf 	茈	*+
rzg 	菰	*+
rzj 	孕	*+
rzl 	艺	*+
rzl 	芤	*+
rzo 	苫	*+
rzof	盐	 +
rzpp	夔	*+
rzps	荪	 +
rzqf	芦	 +
rzs 	荪	*+
rzsb	苹	 +
rzst	苹	 +
rzv 	荐	*+
rzw 	蘧	*+
rzx 	芄	*+
rzz 	艺	*+
s   	三	*+
sa  	小	*+
sa  	糸	*+
saa 	射	*+
saa 	纣	*+
sad 	绘	*+
saf 	线	*+
saja	缚	 +
sal 	它	*+
sam 	纶	*+
sao 	给	*+
saqd	绘	 +
saqj	绒	*+
saqo	缄	 +
saqq	线	 +
saqx	绒	*+
sax 	绂	*+
saxu	绂	 +
saxx	绂	 +
sa, 	さ	*+
sa. 	サ	*+
sb  	绩	*+
sbb 	纵	*+
sbb 	邾	 +
sbbe	纤	 +
sbbo	绤	*+
sbd 	纷	*+
sbef	缢	*+
sbef	缣	 +
sbf 	纶	*+
sbho	缮	*+
sbj 	绊	*+
sbk 	牺	*+
sbkk	牺	 +
sbko	缮	*+
sbkr	牺	 +
sbl 	纰	*+
sbn 	朱	*+
sbnl	绻	 +
sbnp	绻	 +
sbo 	缯	*+
sboh	总	 +
sbqd	缯	 +
sbqp	绨	 +
sbr 	牺	*+
sbt 	绘	*+
sbuh	总	 +
sbv 	缤	*+
sc  	辉	*+
sceb	缋	 +
sceq	缘	 +
scew	绿	 +
scew	缱	*+
scn 	绎	*+
sco 	牺	*+
scrs	缥	*+
scs 	练	*+
scso	辔	*+
sd  	续	*+
sd  	缩	*+
sda 	纫	*+
sdb 	绲	*+
sdbs	缭	 +
sdc 	绝	*+
sdcl	绝	 +
sdez	缇	 +
sdf 	缊	*+
sdfu	缦	 +
sdn 	尖	*+
sdn 	纫	 +
sdo 	绍	*+
sdrk	绔	 +
sds 	尜	*+
sdto	绮	 +
sdto	犄	*+
sdx 	劣	*+
sdy 	劣	*+
se  	生	*+
seb 	兴	*+
sebi	誉	 +
sebq	举	 +
see 	当	 +
see 	纽	 +
see 	绌	 +
seem	缪	 +
sefd	缙	 +
seg 	绥	*+
segu	缓	 +
seh 	绣	*+
sel 	纯	*+
sem 	缪	*+
senu	绶	*+
seq 	缘	 +
seqe	缰	*+
ser 	光	*+
serc	辉	 +
seru	缎	*+
serv	耀	 +
sesi	经	 +
set 	彩	 +
seu 	绌	*+
seud	缙	 +
seuu	绷	 +
sev 	纽	 +
sew 	绿	*+
sew 	犍	*+
sex 	缓	*+
se, 	せ	*+
se. 	セ	*+
sf  	党	*+
sfb 	绑	*+
sfek	缳	 +
sfka	缛	*+
sfl 	纪	*+
sfl 	牝	*+
sfm 	编	*+
sfm 	犏	*+
sfn 	灾	*+
sfoo	躯	 +
sfsw	邋	*+
sfww	继	 +
sfx 	躯	*+
sfy 	纺	*+
sfy 	绎	 +
sfyg	绎	 +
sg  	湿	*+
sge 	缍	*+
sgi 	纠	*+
sgj 	纤	*+
sgjy	缍	 +
sgnf	鹦	*+
sgo 	绀	*+
sgry	缍	 +
sgx 	婴	*+
sh  	掌	*+
shi,	し	*+
shi.	シ	*+
shmb	绩	 +
sho 	绪	*+
shr 	绣	*+
si  	川	*+
si  	个	 +
sia 	缚	*+
sid 	劲	*+
sie 	红	*+
sii 	绅	*+
siqi	绅	 +
sir 	刭	*+
sisa	銮	*+
sisb	脔	*+
sisc	蛮	 +
sise	峦	 +
sisf	鸾	*+
sish	恋	 +
sish	挛	 +
sisp	变	 +
sisq	弯	 +
sisz	孪	 +
sit 	颈	*+
sitb	颈	 +
sits	巯	*+
siw 	迳	*+
si, 	し	*+
si. 	シ	*+
sj  	牛	*+
sj  	卅	*+
sj  	牜	*+
sjae	纤	 +
sjb 	缜	*+
sjm 	续	 +
sjm 	犊	*+
sjmb	缜	 +
sjn 	缇	*+
sjo 	牯	*+
sjqa	缋	 +
sjqs	练	 +
sjyd	续	 +
sjyd	犊	 +
sk  	缘	*+
ska 	纨	*+
ske 	纴	*+
sko 	缄	*+
skt 	缵	*+
skx 	线	*+
sl  	世	*+
sla 	缭	*+
sla 	缡	*+
slad	织	 +
sldk	缞	*+
slho	犒	*+
slho	缟	 +
slk 	纩	*+
sll 	兂	*
slm 	继	*+
slnn	缔	 +
slno	犒	*+
slno	缟	 +
sloo	犒	*+
sloo	缟	 +
slp 	纩	*+
slq 	缠	*+
slqy	缠	 +
slt 	缲	*+
slw 	弦	*+
slws	纤	 +
slww	继	 +
slx 	绞	*+
slxu	缡	*+
sm  	省	*+
smb 	贳	*+
smbd	勚	*+
smbg	缨	 +
sme 	组	*+
smeb	犋	*+
smg 	缕	*+
smii	绗	*+
smit	绗	*+
smiz	纵	 +
sml 	继	*+
sml 	牦	*+
smn 	彩	 +
smo 	省	 +
smo 	眚	*+
smq 	翻	*+
sms 	缈	*+
smx 	缦	*+
sn  	常	*+
sn  	缔	*+
sna 	约	*+
sna 	演	 +
snb 	纳	*+
snb 	绾	*+
snbe	纲	 +
snbf	网	 +
snc 	绝	*+
sncb	缤	 +
sncl	绝	 +
snd 	绚	*+
snd 	劳	 +
sne 	绉	*+
sne 	峃	*+
sne 	纻	*+
sneb	演	 +
sned	衅	 +
snee	绉	 +
snez	绽	*+
sni 	绹	*
snk 	黉	*+
snka	璺	*+
snkb	缤	 +
snm 	物	*+
snmr	觉	 +
snn 	失	*+
snn 	带	 +
snnf	鸴	*+
sno 	尚	*+
sno 	绸	*+
snoa	才	 +
snob	赏	 +
snod	尝	 +
snof	党	 +
snoh	掌	 +
snok	裳	*+
snom	氅	*+
snon	常	 +
snoo	营	 +
snop	敞	*+
snoq	当	 +
snor	党	 +
snor	劏	 +
snot	棠	*+
snoy	堂	 +
snpb	缤	 +
snpd	缩	 +
snr 	制	*+
snrb	黉	 +
snrh	掣	*+
snrk	制	 +
snrs	综	 +
sns 	综	*+
snsb	缤	 +
snsf	毙	 +
snsf	鳖	 +
snsh	憋	 +
snsm	瞥	 +
snsn	币	 +
snso	喾	*+
snsp	敝	 +
snsq	别	 +
snsr	弊	 +
snsz	蹩	 +
snt 	尝	*+
snt 	荣	 +
sntf	爨	*+
snuf	鲎	*+
snv 	缔	*+
snw 	迭	*+
snw 	泶	*+
snwu	绹	 +
snx 	纲	*+
snyo	绸	*+
snz 	学	 +
snz 	绽	*+
so  	当	*+
sob 	织	*+
sob 	郜	*+
sobf	缊
sobw	邋	*+
soc 	邕	*+
socl	邕	 +
sod 	缙	*+
soil	绳	 +
son 	缳	*+
sonf	鹄	*+
soo 	告	*+
soot	缲	 +
soql	绳	 +
sor 	缉	*+
sors	靠	 +
sosw	邋	*+
sot 	捆	*+
sou 	绢	*+
sow 	造	*+
soxd	缗	*+
soxw	邋	*+
so, 	そ	*+
so. 	ソ	*+
sp  	少	*+
sp  	缴	*+
spa 	总	*+
spb 	终	*+
spbo	绺	*+
spbw	缒	*+
spdn	绵	 +
spdp	缴	 +
spdw	线	 +
spdw	缐	*+
spe 	绖	*+
spfd	缑	*+
spfw	缝	*+
spj 	绵	*+
spl 	绻	*+
spn 	绦	*+
spo 	络	*+
spoh	总	 +
spp 	致	*+
sppo	绺	*+
sps 	绛	*+
spt 	缏	*+
spt 	绦	 +
sptx	缏	 +
spu 	级	 +
spv 	缴	*+
spx 	牧	*+
sq  	举	*+
sq  	缘	 +
sqa 	缋	*+
sqd 	甥	*+
sqer	绕	 +
sqh 	缌	*+
sqi 	纼	*+
sqj 	绰	*+
sqjb	郸	*+
sqjk	冁	*+
sqk 	躬	*+
sqn 	缣	*+
sqo 	细	*+
sqo 	犒	*+
sqo 	甾	*+
sqo 	缟	*+
sqoc	襁	*+
sqs 	缧	*+
sqt 	巢	*+
sqtd	剿	*+
sqtr	剿	*+
squc	襁	*+
sqy 	躬	*+
sr  	觉	*+
sr  	党	 +
src 	缂	*+
src 	绬	*+
srfr	缆	 +
sri 	劏	*
srl 	先	*+
srmr	缆	 +
srn 	级	 +
srsb	赞	 +
srsb	酂	*+
srss	绯	*+
srt 	躲	*+
srv 	党	 +
srvr	缆	 +
srw 	选	 +
ss  	靠	*+
ssa 	丝	*+
ssb 	邾	*+
sse 	牲	*+
ssg 	缨	*+
ssi 	经	*+
ssl 	绁	*+
ssn 	朱	*+
ssnf	鸶	*+
ssno	躺	*+
ssno	绱	*+
sso 	牿	*+
ssp 	纱	*+
ssq 	缁	*+
ssqt	缫	*+
ssrb	缵	 +
ssu 	绡	*+
ss, 	っ	*+
ss. 	ッ	*+
st  	街	*+
sta 	顺	*+
sta 	纭	*+
stl 	统	*+
stm 	缃	*+
stmb	顺	 +
stoh	缅	*+
stp 	绨	*+
stqx	绠	 +
str 	统	*+
stx 	绠	*+
su  	级	*+
sue 	肖	*+
sui 	经	*+
sui 	纾	*+
suj 	纡	*+
suo 	绐	*+
suq 	绎	*+
sur 	削	*+
suu 	绷	*+
suuu	缀	*+
suw 	逍	*+
suy 	经	*+
su, 	す	*+
su. 	ス	*+
sv  	带	*+
sv  	耀	*+
sve 	维	*+
sve 	雀	*+
svj 	绋	*+
svl 	缆	*+
svo 	绮	*+
svv 	耀	*+
svz 	纥	*+
sw  	选	*+
swj 	纬	*+
swn 	巡	*+
swn 	邋	*+
swo 	牾	*+
swo 	绤	*
swos	纬	 +
swu 	罂	*+
swuu	缡	*+
swwf	继	 +
swwl	继	 +
swx 	纹	*+
sx  	身	*+
sx  	牜	*
sxa 	抵	*+
sxbd	续	 +
sxbd	犊	 +
sxe 	抵	*+
sxk 	绔	*+
sxl 	绳	*+
sxu 	纮	*+
sxx 	纸	*+
sy  	堂	*+
sya 	特	*+
sybp	绫	 +
syd 	绪	*+
sye 	尘	*+
sye 	牡	*+
sye 	缢	*+
syfb	续	 +
syfb	犊	 +
sym 	续	 +
sym 	犊	*+
synr	续	 +
syo 	结	*+
syob	缬	*+
syot	缬	*+
sypd	绪	 +
syr 	绕	*+
syrp	绫	 +
syx 	绫	*+
syyr	绕	 +
sz  	学	*+
sza 	纨	*+
szdj	绰	 +
szx 	纨	*+
s.  	？	*+
t   	通	*+
ta  	云	*+
ta  	页	*+
taa 	村	*+
tab 	榔	*+
tac 	检	*+
tad 	桧	*+
tadb	榔	 +
tado	枪	 +
tae 	检	*+
taf 	栈	*+
tai 	榆	*+
taj 	桦	*+
tak 	柱	*+
takp	栊	 +
tal 	栊	*+
taob	检	 +
tap 	柃	*+
taqd	桧	 +
taqq	栈	 +
taqr	械	 +
taqs	槭	*+
tase	检	 +
tat 	柃	*+
taur	榆	 +
taxf	栊	 +
ta, 	た	*+
ta. 	タ	*+
tb  	顶	*+
tba 	杯	*+
tbb 	枞	*+
tbe 	橙	*+
tbea	樽	*+
tbee	逭	 +
tbh 	样	 +
tbhi	槎	*+
tbk 	栓	*+
tbki	槎	*+
tbku	样	 +
tbkw	样	 +
tbl 	枇	*+
tbl 	檎	*+
tblu	檎	*+
tbp 	枪	*+
tbpd	楷	*+
tbqj	椫	*+
tbqp	梯	 +
tbs 	栏	*+
tbt 	桧	*+
tbu 	松	*+
tbv 	槟	*+
tbwu	檎	*+
tbxu	椭	*+
tc  	梦	*+
tceq	椽	 +
tcjo	椐	*+
tcl 	杷	*+
tcm 	楣	*+
tcmb	槚	*+
tco 	栖	*+
tcrs	标	 +
tcs 	栋	*+
tcs 	楝	*+
tcsu	榍	*+
tcw 	梿	*+
tcws	樨	*+
td  	动	*+
tdb 	棍	*+
tddq	榴	 +
tde 	查	 +
tdee	榻	*+
tdem	杨	 +
tdg 	杆	*+
tdk 	根	*+
tdl 	概	*+
tdnp	忧	 +
tdo 	百	*+
tdo 	枷	*+
tdo 	杳	*+
tdp 	柳	*+
tdto	椅	 +
tduk	概	 +
tdv 	模	 +
tdx 	动	 +
tdx 	勇	 +
tdy 	动	 +
tdy 	勇	 +
te  	查	*+
ted 	桤	*+
tede	桓	*+
tedo	桥	 +
tee 	栩	*+
tee 	榋	*+
teee	榋	*
teev	棹	 +
tef 	棂	*+
tefe	桠	 +
tefl	桤	 +
teh 	椽	*+
tej 	本	*+
tek 	枨	*+
ten 	柄	*+
tenb	柄	 +
tenu	叆	*+
tep 	杨	*+
teq 	榉	*+
ter 	杌	*+
teru	椴	*+
tew 	棣	*+
tew 	楗	*+
teww	叇	*+
tez 	桴	*+
te, 	て	*+
te. 	テ	*+
tf  	码	*+
tfa 	杰	*+
tfb 	梆	*+
tfb 	朴	 +
tfc 	椤	*+
tfcb	柜	 +
tfcl	栀	 +
tfdd	楔	*+
tfed	朴	 +
tff 	柜	*+
tff 	楞	*+
tfk 	框	*+
tfl 	杞	*+
tfn 	楱	*+
tfnd	椿	*+
tfnd	楱	 +
tfng	桩	 +
tfnh	榛	*+
tfnn	柩	*+
tfnn	楱	 +
tfnq	棒	 +
tfoo	枢	 +
tfp 	栀	*+
tfq 	柜	*+
tfrs	榧	*+
tfs 	栎	*+
tfsu	椒	*+
tfv 	柜	*+
tfx 	枢	*+
tfy 	枋	*+
tg  	机	*+
tge 	棰	*+
tge 	桕	*+
tgi 	桥	*+
tgj 	杆	*+
tgjy	棰	 +
tgno	桥	 +
tgnr	桥	 +
tgo 	柑	*+
tgo 	桥	 +
tgo 	栝	*+
tgry	棰	 +
tgy 	榜	*+
th  	想	*+
tha 	恿	*+
thdd	楔	*+
thf 	楸	*+
tho 	楮	*+
thx 	梭	*+
ti  	丁	*+
ti  	歌	*+
tie 	杠	*+
tih 	槠	*+
timb	杠	 +
tiq 	柚	*+
tirp	橄	*+
tiv 	歌	*+
tiyd	槠	 +
ti, 	ち	*+
ti. 	チ	*+
tj  	面	*+
tj  	甬	*+
tjbo	樯	*+
tjd 	橙	*+
tje 	植	*+
tje 	构	 +
tjeg	栖	 +
tjg 	栖	*+
tjl 	植	*+
tjm 	椟	*+
tjme	植	 +
tjml	植	 +
tjng	楠	 +
tjny	构	 +
tjo 	枯	*+
tjp 	材	*+
tjqs	楝	*+
tjqs	栋	 +
tju 	枝	*+
tjyd	椟	 +
tk  	听	*+
tka 	横	*+
tka 	柝	*+
tkb 	棋	*+
tkbl	椹	*+
tke 	枉	*+
tki 	析	*+
tkk 	朽	*+
tkl 	枕	*+
tkl 	椹	*+
tklb	椹	*+
tklr	椹	*+
tkoe	极	 +
tkpd	皙	*+
tkrl	椹	*+
tkw 	梃	*+
tkx 	栈	*+
tl  	充	*+
tlbi	橛	*+
tld 	枥	*+
tlda	橱	*+
tldj	樟	*+
tldk	榱	*+
tlh 	核	*+
tlhb	椁	 +
tlho	槁	 +
tlj 	梓	*+
tll 	札	*+
tll 	榇	 +
tln 	柿	*+
tln 	梾	*+
tlnf	榜	 +
tlno	槁	 +
tlo 	柘	*+
tlob	椁	 +
tloe	檀	*+
tloh	檩	*+
tlom	檀	*+
tloo	槁	 +
tlos	椋	*+
tlos	檩	 +
tloz	椁	 +
tlr 	杭	*+
tls 	扎	*+
tls 	椋	*+
tlt 	榇	*+
tltr	榇	 +
tlu 	板	*+
tlul	栊	 +
tlx 	校	*+
tly 	桩	*+
tlya	橱	*+
tlz 	椁	*+
tm  	相	*+
tm  	梅	*+
tmaq	戛	*+
tmb 	页	*+
tmbg	樱	 +
tmcs	栏	 +
tme 	查	 +
tmf 	杩	*+
tmg 	楼	*+
tmh 	想	 +
tmii	桁	*+
tmit	桁	*+
tmiz	枞	 +
tmj 	栅	*+
tmjs	栏	 +
tmmm	橇	*+
tmn 	栏	*+
tmno	橘	*+
tmnp	忧	 +
tmo 	相	 +
tmoo	榈	*+
tmov	榈	*+
tmp 	夏	*+
tmp 	杉	*+
tmr 	枧	*+
tmth	懋	*+
tmv 	梅	*+
tn  	木	*+
tna 	杓	*+
tnb 	棺	*+
tnb 	丙	 +
tnb 	枘	*+
tnbb	两	 +
tnbb	邴	 +
tnbe	榨	*+
tnbf	榨	*+
tnbi	檐	 +
tnbo	榕	 +
tncb	槟	 +
tncq	橡	 +
tnd 	槲	*+
tne 	楦	*+
tne 	桷	*+
tnee	楦	 +
tneo	桐	*+
tnf 	柁	*+
tnf 	鹈	*+
tng 	桉	*+
tnht	柠	 +
tnj 	楠	*+
tnj 	桷	*+
tnj 	檫	*+
tnjs	檫	*+
tnkb	槟	 +
tnli	檐	 +
tnlp	桅	 +
tnn 	橡	*+
tnne	栅	 +
tno 	枸	*+
tnp 	桅	*+
tnpb	槟	 +
tnq 	甬	*+
tnqd	勇	 +
tnqh	恿	 +
tnqw	通	 +
tnr 	而	 +
tnr 	栅	 +
tnr 	枕	 +
tnra	耐	 +
tnre	榨	*+
tnrf	榨	*+
tnrf	鸸	 +
tnrg	耍	 +
tnrh	恧	*+
tnrs	棕	 +
tns 	棕	*+
tnsb	槟	 +
tnt 	柠	*+
tnu 	构	*+
tnv 	榷	*+
tnw 	榕	*+
tny 	再	 +
to  	可	*+
to  	凸	*+
toa 	检	*+
tob 	枳	*+
tod 	拐	*+
toe 	桠	*+
toh 	面	 +
tohr	腼	*+
tok 	枵	*+
too 	可	 +
too 	杏	*+
tooe	噩	 +
tool	噩	 +
tooo	榀	*+
toq 	榴	*+
tor 	楫	*+
tot 	捆	*+
toti	歌	 +
toto	哥	 +
to, 	と	*+
to. 	ト	*+
tp  	弟	*+
tp  	丆	*
tpa 	朴	*+
tpbw	槌	*+
tpd 	柏	*+
tpdj	槔	*+
tpdk	概	 +
tpdn	棉	 +
tpdo	桥	 +
tpdp	檄	*+
tpdr	桥	 +
tpdt	栎	 +
tpdt	槔	 +
tpe 	桎	*+
tpfj	桦	 +
tpj 	棉	*+
tpj 	枰	*+
tpo 	格	*+
tpqu	魂	 +
tpqu	槐	 +
tpu 	极	 +
tpx 	枚	*+
tq  	棒	*+
tq  	杖	*+
tqd 	勇	*+
tqer	桡	 +
tqi 	柙	*+
tqj 	棹	*+
tqo 	槁	*+
tqt 	棵	*+
tqu 	画	*+
tqur	划	 +
tqv 	杖	*+
tqx 	更	 +
tqx 	杖	 +
tqxs	苏	 +
tr  	械	*+
tra 	桃	*+
trb 	椰	*+
trbb	桃	 +
trc 	枫	*+
trc 	槿	*+
trdd	模	 +
tre 	权	*+
treb	横	 +
trf 	槛	*+
trfd	槽	*+
trfr	榄	 +
tri 	剃	*+
trj 	弃	*+
trjq	桦	 +
trk 	栲	*+
trl 	充	 +
trl 	机	 +
trmr	榄	 +
trn 	极	 +
trn 	栎	 +
trnq	檬	*+
trod	槽	*+
trov	权	 +
trp 	敢	*+
trp 	栉	 +
trph	憨	*+
trs 	标	 +
trs 	柰	*+
trsw	隶	*+
trt 	弃	*+
truf	楹	*+
trvf	槛	 +
trvr	榄	 +
trx 	枫	*+
trz 	机	 +
ts  	标	*+
ts  	禁	 +
tsa 	榭	*+
tsb 	株	*+
tscq	橼	*+
tse 	档	*+
tseq	榉	 +
tser	桄	*+
tsg 	樱	*+
tsnq	档	 +
tsny	樘	*+
tso 	档	*+
tso 	梏	*+
tsp 	杪	*+
tss 	株	*+
tst 	弃	*+
tsu 	梢	*+
tsuv	っ	 +
tsuv	ッ	 +
tsu,	つ	*+
tsu,	っ	*+
tsu.	ツ	*+
tsu.	ッ	*+
tsv 	禁	 +
tt  	哥	*+
tta 	顶	 +
ttb 	郴	*+
ttbd	棼	*+
ttc 	梦	 +
ttde	楂	*+
tte 	台	 +
ttf 	焚	*+
ttfb	楚	 +
ttfk	农	 +
ttg 	婪	*+
tti 	歌	*+
ttj 	桶	*+
ttlb	麓	*+
ttm 	彬	*+
ttm 	楂	*+
ttmb	顶	 +
ttn 	林	*+
ttnb	柄	 +
ttnq	桶	 +
tto 	柯	*+
tto 	哥	 +
ttp 	梯	*+
ttqx	梗	 +
ttra	梵	 +
ttrp	橄	*+
ttrs	禁	 +
tts 	梳	*+
ttt 	森	*+
ttx 	梗	*+
ttyz	楚	 +
ttz 	梵	*+
tt, 	っ	*+
tt. 	ッ	*+
tu  	极	*+
tua 	树	*+
tua 	杈	*+
tubp	梭	 +
tue 	育	*+
tufd	橹	*+
tui 	杼	*+
tuo 	台	 +
tuoo	棂	 +
tup 	材	*+
tuq 	檑	*+
turk	樗	*+
turp	梭	 +
tuu 	棚	*+
tuv,	っ	*+
tuv.	ッ	*+
tux 	权	*+
tuy 	柽	*+
tu, 	つ	*+
tu, 	っ	*+
tu. 	ツ	*+
tu. 	ッ	*+
tv  	模	*+
tva 	魂	*+
tva 	槐	*+
tve 	椎	*+
tve 	权	 +
tvf 	樵	*+
tvf 	柞	*+
tvj 	榫	*+
tvl 	榄	*+
tvn 	朴	*+
tvo 	椅	*+
tvo 	檐	 +
tvom	梅	 +
tv, 	っ	*+
tv. 	ッ	*+
tw  	禁	*+
tw  	标	 +
twb 	机	 +
twdt	梁	 +
twj 	杵	*+
twm 	杨	*+
twn 	运	*+
twn 	通	 +
twn 	递	*+
two 	梧	*+
twoe	极	 +
twoo	樯	*+
twpf	楹	*+
twpt	栎	 +
tws 	桫	*+
twum	郁	 +
twv 	标	 +
twwb	机	 +
tx  	更	*+
txa 	柢	*+
txbd	椟	 +
txe 	柢	*+
txxd	樊	*+
txxh	攀	*+
txxm	郁	 +
txxo	矾	*+
ty  	样	*+
tybp	棱	 +
tyd 	楮	*+
tyda	树	 +
tye 	杜	*+
tyfb	椟	 +
tym 	椟	*+
tyo 	桔	*+
tyoa	树	 +
tyop	台	 +
typd	楮	 +
typf	栳	*+
typk	栲	 +
tyr 	桡	*+
tyrp	棱	 +
tyx 	棱	*+
tyy 	桂	*+
tyyr	桡	 +
tyzi	樾	*+
tz  	楚	*+
tzap	栉	 +
tzc 	栌	*+
tzdj	棹	 +
tzdp	栉	 +
tzj 	李	*+
tzmb	桢	*+
tzp 	栉	*+
u   	以	*+
ua  	雨	*+
uaa 	对	*+
uaa 	叉	 +
uaa 	肘	*+
uac 	蚤	*+
uac 	脸	 +
uad 	脍	*+
uadf	然	 +
uae 	脸	*+
uah 	怼	*+
uai 	腧	*+
uaja	膊	 +
uajq	脯	 +
uakp	胧	 +
ual 	胧	*+
uaob	脸	 +
uap 	零	*+
uaq 	戏	 +
uaqd	脍	 +
uase	脸	 +
uat 	零	*+
uaur	腧	 +
uav 	叉	*+
uax 	叉	*+
uax 	肞	*
uaxb	腻	*+
uaxf	胧	 +
uazr	虢	*+
ub  	预	*+
uba 	以	 +
ubb 	於	*+
ubb 	于	 +
ubbp	脚	 +
ubby	脞	*+
ubc 	蚤	*+
ube 	胚	*+
ubed	朕	 +
ubgn	朕	 +
ubho	膳	*+
ubi 	邓	*+
ubj 	胖	*+
ubk 	胼	*+
ubko	膳	*+
ubm 	胗	*+
ubn 	以	 +
ubnb	剩	 +
ubnd	胜	 +
ubnf	腾	*+
ubng	媵	*+
ubni	誊	*+
ubnw	滕	*+
ubny	塍	*+
ubor	脱	 +
ubpp	皴	*+
ubpw	逡	*+
ubt 	脍	*+
ubv 	膑	*+
uc  	胸	*+
uca 	虽	*+
ucg 	腰	*+
uci 	肿	*+
ucj 	肿	*+
ucl 	肥	*+
ucol	霹	 +
ucrs	膘	*+
ucs 	胨	*+
ucv 	虽	*+
ucw 	脲	*+
ud  	脂	*+
uda 	肽	*+
udb 	胁	*+
uddq	溜	 +
ude 	胆	*+
udem	肠	 +
udf 	腽	*+
udil	腌	 +
udk 	艰	*+
udkw	腿	 +
udm 	参	 +
udmm	毵	 +
udo 	昶	*+
udq 	畚	*+
udql	腌	 +
udrk	胯	 +
uds 	叁	 +
uds 	腥	 +
udv 	膜	*+
udx 	劝	*+
udx 	肋	*+
udy 	劝	*+
udy 	肋	*+
ue  	月	*+
ueba	鳉	*
ued 	鲁	*+
uee 	雪	*+
ueem	胶	 +
uek 	胀	*+
uel 	肫	*+
uem 	胶	*+
uen 	胰	*+
ueo 	凹	*+
ueot	膈	*+
uep 	肠	*+
ueq 	豚	*+
ueqq	霾	*+
uer 	兕	*+
uesi	胫	 +
uew 	腱	*+
uez 	脬	*+
uf  	熊	*+
ufa 	鱼	*+
ufa 	熊	 +
ufa 	鲅	*+
ufah	鲶	*+
ufah	鳡
ufak	鱿	*+
ufau	鲅	*+
ufax	鲅	*+
ufb 	腆	*+
ufba	鳟	*+
ufbf	鳒	*+
ufbh	鲜	 +
ufbo	鳝	*+
ufbt	鲙	*+
ufc 	鲃	*+
ufca	鳚	*+
ufcl	鲃
ufcs	鳔	*+
ufcw	鲢	*+
ufd 	鲁	*+
ufd 	脂	 +
ufd 	鱽	*+
ufda	鲥	*+
ufdb	鲲	*+
ufdd	鲳	*+
ufde	鳎	*+
ufdf	鳁	*+
ufdp	鲫	 +
ufdu	鳗	 +
ufdz	鳀	*+
ufe 	盂	*+
ufe 	鲀	*+
ufea	鲟	*+
ufea	鲡	 +
ufed	鳛	*+
ufee	鳐	*+
ufeo	鲪	*+
ufeq	鲾	*+
ufes	鲧	*+
ufeu	鳐	*+
uff 	鲂	*+
uffb	鳏	*+
uffd	鳢	*+
uffk	脓	 +
uffl	鱾	*+
uffm	鳊	*+
uffo	鲘	*+
uffq	鳏	*+
uffw	鳏	*+
ufg 	鲫	*+
ufg 	鳑	*
ufga	鳉	*+
ufgr	鲵	*+
ufh 	稣	*+
ufh 	鲥	*+
ufhf	鳅	*+
ufhu	鲭	*+
ufiq	鲉	*+
ufj 	鲼	*+
ufj 	鳀	*
ufjb	鲼	 +
ufk 	震	*+
ufkb	鲯	*+
ufkh	鳡	*+
ufko	鳄	 +
ufl 	鲡	*+
uflf	鳑	*+
ufli	鳜	*+
uflq	鳙	*+
ufls	鲸	*+
uflx	鲛	*+
ufm 	鳗	*+
ufmc	鳞	*+
ufmr	鲗	*+
ufms	鳞	*+
ufn 	炙	*+
ufn 	鲍	*+
ufn 	鲷	*+
ufn 	腠	*+
ufn 	以	 +
ufnd	腠	*+
ufnl	鲍	*+
ufnn	腠	*+
ufno	鲷	*+
ufno	鲖	*+
ufnr	鲩	*+
ufo 	鳄	*+
ufof	鳁	*
ufok	鳄	 +
ufoo	鲴	*+
ufp 	胩	*+
ufp 	鲆	*+
ufp 	鲦	*+
ufp 	鲏	*+
ufpa	鲋	*+
ufpd	鲌	*+
ufpk	鳇	*+
ufps	鲧	*+
ufpt	鲦	*+
ufpw	鳈	*+
ufq 	鲤	*+
ufq 	鳒	*
ufqh	鳃	*+
ufqk	鳂	*+
ufr 	鲕	*+
ufrd	鳓	*+
ufrd	鳢	 +
ufrs	鲱	*+
ufru	鲰	*+
ufru	鳠	*+
ufry	鲣	*+
ufsq	鲻	*+
ufst	鲽	*+
ufst	鲿	*+
uft 	鲠	*+
uft 	鲬	*+
ufte	鳄	 +
uftl	鳄	 +
ufto	鲄	*+
uftq	鲬	*
uftr	鲕	 +
uftx	鲠	 +
ufuc	鳋	*+
ufue	鳕	*+
ufum	鲹	*+
ufuo	鲐	*+
ufuu	鳐	*+
ufv 	鳆	*+
ufvf	鲊	*+
ufvp	鳆	 +
ufwh	鲚	*+
ufwr	鲚	*+
ufxu	鲔	*+
ufy 	肪	*+
ufy 	鲮	*+
ufyd	鳍	*+
ufyk	鲓	*+
ufyo	鲒	*+
ufyp	鲮	*+
ufyy	鲑	*+
ufzc	鲈	*+
ufzc	鲺	*+
ufzf	鲈	*+
ufzo	鲇	*+
ug  	脾	*+
uga 	胍	*+
ugb 	腴	*+
ugj 	肝	*+
ugn 	朕	*+
ugn 	胍	 +
ugq 	肿	*+
ugr 	霓	*+
ugw 	膝	*+
ugy 	膀	*+
uh  	鲜	*+
uha 	态	*+
uhu 	腈	*+
ui  	予	*+
ui  	凵	*+
uia 	膊	*+
uid 	劲	*+
uid 	霭	*+
uidl	霭	*+
uie 	肛	*+
uii 	胂	*+
uij 	脯	*+
uin 	欢	*+
uin 	肷	*+
uiqi	胂	 +
uiql	电	 +
uir 	刭	*+
uit 	颈	*+
uitb	颈	 +
uits	巯	*+
uiw 	迳	*+
uj  	于	*+
uj  	於	*+
ujj 	肼	*+
ujn 	肺	*+
ujng	腩	 +
ujnz	脖	*+
ujqb	胰	 +
uju 	肢	*+
uk  	粤	*+
uke 	雩	*+
ukw 	霆	*+
ul  	能	*+
ulbf	臁	 +
uld 	雳	*+
uldh	臆	*+
ulg 	霎	*+
ulh 	胲	*+
ulhz	雳	 +
ulk 	脉	*+
uln 	肺	*+
ulnf	膀	 +
ulno	膪	*+
ulo 	露	*+
uloe	膻	*+
ulom	膻	*+
ulpa	腑	*+
ulpu	腋	*+
ulq 	臁	*+
ulr 	肮	*+
ult 	臊	*+
ulul	胧	 +
ulwv	臃	*+
ulx 	胶	*+
ulx 	腋	*+
ulxu	脑	 +
uly 	脏	*+
um  	参	*+
umb 	贠	*+
umc 	膦	*+
umcs	膦	 +
umm 	毵	*+
umn 	脒	*+
ump 	参	 +
ump 	肜	*+
umpd	雾	 +
umr 	观	*+
umv 	膨	*+
un  	永	*+
unb 	肭	*+
unbi	腔	*+
unbi	胆	 +
unbp	膣	*+
uncb	膑	 +
uncp	腕	*+
uncq	豫	 +
uneo	胴	*+
unez	腚	 +
unf 	鸡	*+
ung 	胺	*+
unj 	腩	*+
unk 	脓	*+
unkb	膑	 +
unl 	胞	*+
unl 	雹	*+
unli	胆	 +
unlp	脆	 +
unn 	豫	*+
uno 	朐	*+
unol	胞	 +
unol	雹	 +
unp 	脆	*+
unpb	膑	 +
unri	腔	*+
unrp	膣	*+
unrr	脘	*+
unrs	腙	 +
uns 	腙	*+
unsb	膑	 +
unxu	胸	 +
unz 	腚	*+
uo  	台	*+
uo  	凹	*+
uoa 	脸	*+
uob 	邰	*+
uobf	腽	 +
uod 	胭	*+
uof 	炱	*+
uofu	霞	 +
uoh 	怠	*+
uok 	腭	*+
uok 	腘	*+
uoka	腘	*
uonb	脶	*+
uoo 	台	 +
uoob	酃	*+
uook	腭	 +
uoot	臊	 +
uoow	灵	 +
uoq 	溜	*+
uow 	迨	*+
uox 	霞	*+
uozo	露	 +
up  	才	*+
up  	脚	 +
upd 	雾	*+
updw	腺	*+
upg 	脾	 +
upj 	霹	*+
upo 	胳	*+
upqg	脾	 +
upu 	服	 +
upv 	脚	 +
uq  	戏	*+
uqdh	恳	 +
uqdo	貂	*+
uqdy	垦	 +
uqgr	貌	 +
uqgw	邈	*+
uqh 	腮	*+
uqi 	胛	*+
uql 	电	*+
uqn 	肤	*+
uqna	豹	*+
uqo 	雷	*+
uqo 	脶	*+
uqp 	豸	*+
uqpb	貔	*+
uqpo	貉	*+
uqpr	貌	 +
uqpt	貅	*+
uqpw	邈	*+
uqq 	狸	*+
uqrd	貘	*+
uqrq	猫	 +
uqtd	貊	*+
uqu 	豺	*+
ur  	脱	*+
urar	脏	 +
urcu	霸	 +
urd 	腊	*+
urdd	膜	 +
uri 	需	*+
uri 	刖	*+
urj 	弁	*+
urk 	雩	*+
urk 	肟	*+
url 	允	*+
url 	肌	 +
url 	兕	 +
urnq	朦	*+
urob	腆	 +
urok	脓	 +
urpp	皴	*+
urpw	逡	*+
urr 	朊	*+
urss	霏	*+
urss	腓	*+
urt 	颥	*+
urtb	颥	 +
uru 	股	*+
urup	霰	 +
urv 	貌	*+
urx 	霰	*+
urz 	肌	*+
us  	叁	*+
use 	胜	*+
use 	叁	 +
user	胱	*+
usfs	腊	 +
usi 	胫	*+
usj 	牟	*+
usl 	腊	*+
usny	膛	*+
uso 	脑	*+
usos	腊	 +
uspo	脑	 +
uspx	脑	 +
usrb	臜	*+
usu 	霄	*+
usv 	腥	*+
uswu	脑	 +
usx 	脑	*+
usxu	脑	 +
ut  	衡	*+
uta 	预	 +
uta 	云	 +
utbw	膝	 +
utm 	霜	*+
utmb	预	 +
utmf	鹴	*+
utnb	颥	 +
utnr	需	 +
utnt	颥	 +
utoh	腼	*+
utt 	霖	*+
uttk	脓	 +
utw 	膝	*+
uu  	服	*+
uu  	霸	*+
uua 	厸	*+
uua 	肞	*
uue 	朋	*+
uues	繇	*+
uuff	能	 +
uuff	熊	 +
uufh	态	 +
uui 	胫	*+
uun 	脉	*+
uunf	鹏	*+
uunf	鹞	 +
uuo 	胎	*+
uups	繇	*+
uuqq	霾	*+
uuu 	厽	*+
uuub	颡	*+
uuum	叠	 +
uuum	参	 +
uuum	毵	 +
uuus	叁	 +
uuut	桑	*+
uuut	颡	 +
uuuy	垒	*+
uuv 	霸	*+
uuw 	遥	 +
uux 	双	*+
uuy 	胫	*+
uv  	幽	*+
uvd 	矣	*+
uvdp	腹	 +
uve 	难	*+
uve 	霍	 +
uvf 	胙	*+
uvo 	胆	*+
uvom	霉	*+
uvv 	霍	*+
uvx 	腹	*+
uvx 	腰	 +
uv, 	ぅ	*+
uv. 	ゥ	*+
uw  	腿	*+
uwek	霪	*+
uwf 	为	 +
uwh 	脐	*+
uwh 	霁	*+
uwjn	霈	*+
uwln	霈	*+
uwm 	肠	*+
uwn 	迂	*+
uwp 	脚	 +
uwr 	脐	*+
uwr 	霁	*+
uwu 	脑	*+
uwuf	鹞	*+
uwus	繇	*+
uwuw	遥	 +
uwv 	灵	 +
uwx 	雯	*+
uwzo	沾	 +
ux  	又	*+
uxa 	胝	*+
uxa 	肞	*+
uxe 	胝	*+
uxk 	胯	*+
uxl 	腌	*+
uxt 	脎	*+
uxu 	肱	*+
uy  	肚	*+
uyd 	劲	*+
uydm	膨	 +
uydu	臌	*+
uye 	圣	*+
uye 	肚	 +
uyom	膨	 +
uyr 	刭	*+
uyt 	颈	*+
uytb	颈	 +
uyts	巯	*+
uyup	脚	 +
uyv 	肚	 +
uyw 	迳	*+
uz  	脚	*+
uzc 	胪	*+
uzqf	胪	 +
u,  	う	*+
u,  	ぅ	*+
u.  	ウ	*+
u.  	ゥ	*+
v   	要	*+
va  	鬼	*+
vaa 	衬	*+
vae 	裣	*+
vajq	补	 +
vao 	袷	*+
vaob	裣	 +
vase	裣	 +
vaw 	迤	*+
vax 	发	 +
vax 	魃	*+
vaxu	发	 +
vaxu	魃	 +
vaxx	魃	*+
vay 	衿	*+
vb  	赖	*+
vbbo	裕	 +
vbj 	袢	*+
vbnp	鬈	 +
vbv 	鬓	*+
vc  	舞	*+
vca 	虿	*+
vcjo	裾	*+
vcw 	裢	*+
vd  	智	*+
vdby	矬	*+
vdc 	艴	*+
vdd 	短	*+
vde 	袒	*+
vdeo	矫	 +
vdff	矩	*+
vdft	榘	*+
vdg 	矫	*+
vdgo	矫	 +
vdgr	矫	 +
vdhg	矮	 +
vdj 	魁	*+
vdk 	裉	*+
vdkw	褪	*+
vdl 	褐	*+
vdn 	矢	*+
vdnl	褐	 +
vdnm	裼	 +
vdo 	知	*+
vdo 	髫	*+
vdod	智	 +
vdp 	初	*+
vdp 	复	 +
vdp 	覆	 +
vdpo	矫	 +
vdpr	矫	 +
vdqi	矧	*+
vdv 	雉	*+
vdx 	劢	*+
vdx 	劝	 +
vdy 	劢	*+
vdy 	劝	 +
ve  	佳	*+
ve  	隹	*+
veb 	魉	*+
veed	褶	*+
vej 	事	*+
venb	魉	 +
veo 	裙	*+
vep 	裼	*+
ver 	髡	*+
vf  	费	*+
vfa 	焦	*+
vfc 	舞	 +
vfcs	舞	 +
vfe 	乍	*+
vfek	鬟	 +
vff 	无	*+
vffu	褙	*+
vfh 	怎	 +
vfka	褥	*+
vfm 	褊	*+
vfnf	鹪	*+
vfr 	劁	*+
vfu 	摆	 +
vfu 	胡	 +
vfuf	摆	 +
vfw 	迮	*+
vfx 	发	 +
vfyu	摆	 +
vg  	矮	*+
vgn 	袄	*+
vh  	怎	*+
vhf 	鬏	*+
vhk 	裱	*+
vho 	褚	*+
vi  	差	*+
vii 	丫	*+
vij 	补	*+
vin 	欢	*+
vin 	欹	*+
viq 	袖	*+
viv 	雠	*+
vj  	弗	*+
vjj 	隼	*+
vjn 	袂	*+
vjou	胡	 +
vk  	囊	*+
vke 	衽	*+
vkn 	衷	*+
vl  	览	*+
vla 	魑	*+
vlc 	裤	*+
vll 	衬	*+
vln 	禳	*+
vlok	禳	 +
vltr	衬	 +
vlxu	魑	 +
vlzr	褫	*+
vm  	每	*+
vmb 	费	 +
vmcs	襕	*
vmd 	裥	*+
vmd 	襇	*+
vmg 	褛	*+
vmi 	隽	*+
vmjs	襕	*+
vml 	髦	*+
vmp 	衫	*+
vmr 	观	*+
vmt 	须	 +
vmtb	须	 +
vmy 	隽	*+
vn  	赢	*+
vnb 	衲	*+
vnbf	魍	*+
vnc 	艴	*+
vnc 	裈	*+
vncb	鬓	 +
vncl	艴	 +
vnkb	鬓	 +
vnl 	袍	*+
vnlc	蠹	*+
vnlt	橐	*+
vnok	囊	 +
vnol	袍	 +
vnpb	鬓	 +
vnrs	鬃	 +
vns 	鬃	*+
vnsb	鬓	 +
vny 	髯	*+
vo  	詹	*+
vo  	奇	*+
voa 	裣	*+
vok 	裎	*+
vom 	每	 +
vomf	鳘	 +
vomp	敏	 +
voms	繁	 +
voms	毓	*+
von 	鬟	*+
voo 	售	*+
voob	裣	 +
voxf	鳘	 +
voz 	趸	*+
vp  	复	*+
vp  	髟	*+
vpa 	补	*+
vpad	袱	*+
vpd 	袄	*+
vpg 	裨	*+
vpl 	鬈	*+
vpnd	袄	 +
vpo 	袼	*+
vpob	袄	 +
vpot	褓	*+
vpqg	裨	 +
vpt 	髹	*+
vpx 	被	*+
vq  	蓄	*+
vqb 	魅	*+
vqe 	里	 +
vqj 	襅	*+
vqoc	襁	*+
vqrj	襅
vqrq	襅
vqt 	裸	*+
vquc	襁	*+
vr  	兑	*+
vrao	褡	 +
vrf 	褴	*+
vrfa	袜	 +
vrfb	袜	 +
vrfe	袜	 +
vrfv	袜	 +
vri 	剞	*+
vro 	褡	*+
vrp 	隽	*+
vrvf	褴	 +
vs  	繁	*+
vsa 	繁	 +
vsa 	尔	 +
vsd 	敕	*+
vsdb	赖	 +
vse 	裆	*+
vsfs	鬣	 +
vsj 	年	*+
vsl 	鬣	*+
vsn 	束	*+
vsnb	赖	 +
vsnq	裆	 +
vso 	裆	*+
vsos	鬣	 +
vsp 	敕	*+
vspz	整	 +
vsr 	剌	*+
vst 	赖	 +
vstb	赖	 +
vsu 	魈	*+
vsw 	速	 +
vt  	集	*+
vtbu	松	 +
vtn 	集	 +
vtnb	魉	 +
vtts	襟	*+
vtxh	襻	*+
vu  	贩	*+
vua 	衩	*+
vuf 	鳘	*+
vui 	隽	*+
vur 	襦	*+
vutr	襦	 +
vuuu	裰	*+
vux 	只	*+
vux 	叓
vuy 	隽	*+
vu, 	ゔ	*+
vu. 	ヴ	*+
vv  	、	*+
vvdp	复	 +
vvu 	双	*+
vvx 	复	 +
vw  	速	*+
vwj 	袆	*+
vwn 	迈	*+
vwn 	进	 +
vwo 	裕	*+
vwuu	魑	 +
vx  	敏	*+
vx  	复	 +
vx  	覆	 +
vxx 	吏	*+
vxx 	只	 +
vxxh	襻	*+
vy  	万	*+
vyd 	褚	*+
vyo 	髻	*+
vypd	褚	 +
vys 	袜	*+
vys 	魅	 +
vyyp	褂	*+
vz  	勒	*+
vzf 	髭	*+
vzl 	乞	*+
vzw 	迄	*+
vzz 	乞	*+
v.  	！	*+
v[  	ⅸ	*+
v]  	ⅹ	*+
w   	五	*+
wa  	为	*+
wa  	瓦	*+
wa  	么	*+
waa 	对	*+
wab 	乡	 +
wabd	响	 +
wabo	向	 +
wabx	飨	 +
wad 	浍	*+
wada	沩	 +
wadb	乡	 +
wadd	响	 +
wadk	浪	 +
wadk	溉	 +
wado	向	 +
wado	沧	 +
wadx	飨	 +
wae 	淦	*+
wae 	鎏	*+
waf 	浅	*+
wai 	渝	*+
waja	溥	 +
wajq	浦	 +
wak 	注	*+
wakp	泷	*+
wal 	池	*+
wal 	泷	*+
wam 	沦	*+
wan 	浪	*+
wao 	洽	*+
waom	瀹	*+
waop	潋	 +
wap 	潋	*+
wap 	泠	*+
waqf	灭	 +
waqo	减	 +
waqq	浅	 +
wasp	潋	 +
wat 	涂	 +
wat 	沭	*+
wat 	泠	*+
watu	溆	*+
waty	涂	 +
waur	渝	 +
wav,	ゎ	*+
wav.	ヮ	*+
waxf	泷	*+
waxu	泼	 +
waxu	韨	*+
wa, 	わ	*+
wa, 	ゎ	*+
wa, 	は	*+
wa. 	ワ	*+
wa. 	ヮ	*+
wa. 	ハ	*+
wb  	颜	*+
wba 	几	 +
wba 	滏	*+
wbat	滁	*+
wbbh	滁	*+
wbbo	浴	 +
wbbu	函	 +
wbd 	汾	*+
wbd 	泐	*+
wbdf	湓	*+
wbe 	澄	*+
wbef	溢	 +
wber	湔	 +
wbeu	溯	*+
wbew	滋	 +
wbf 	沦	*+
wbh 	洋	*+
wbh 	涂	 +
wbhu	溆	*+
wbhy	涂	 +
wbi 	湔	*+
wbj 	泮	*+
wbku	漾	*+
wbkw	漾	*+
wbo 	沿	*+
wbp 	沧	*+
wbqp	涕	 +
wbs 	澜	*+
wbs 	斓	*+
wbt 	浍	*+
wbu 	脊	*+
wbuf	鹡	*
wbv 	滨	*+
wbwf	沩	 +
wbxa	滏	*+
wbxe	滏	*+
wbz 	泛	*+
wc  	浊	*+
wca 	汐	*+
wca 	浊	 +
wcch	漶	*+
wcd 	沏	*+
wcdj	潭	 +
wce 	溘	*+
wceb	溃	 +
wcew	渌	 +
wcf 	泥	*+
wci 	冲	*+
wcj 	冲	*+
wck 	渐	*+
wcm 	湄	*+
wcn 	泱	*+
wcn 	泽	 +
wcnb	浕	*+
wcnr	涮	*+
wco 	洒	*+
wcp 	渥	*+
wcrs	漂	 +
wcru	淀	 +
wct 	柒	*+
wct 	溧	*+
wcu 	漏	*+
wcw 	涟	*+
wcy 	湮	*+
wczz	潺	*+
wd  	潜	*+
wda 	汰	*+
wda 	韧	 +
wdam	粱	*+
wdat	梁	 +
wdaz	涩	*+
wdb 	混	*+
wdbm	粱	*+
wdbs	潦	 +
wdbt	梁	 +
wdcr	浼	*+
wddq	溜	 +
wddr	浏	*+
wde 	冱	*+
wdee	溻	*+
wdef	烫	 +
wdef	荡	 +
wdem	汤	 +
wdf 	温	*+
wdf 	韫	*+
wdfe	湿	 +
wdfu	漫	 +
wdi 	湍	*+
wdil	淹	 +
wdl 	渴	*+
wdl 	溉	 +
wdlb	灏	*+
wdlt	灏	*+
wdn 	韧	*+
wdnl	渴	 +
wdo 	沼	*+
wdo 	汨	*+
wdo 	沓	*+
wdo 	汩	*+
wdp 	泖	*+
wdql	淹	 +
wdr 	洌	*+
wdrw	瀑	*+
wduk	溉	 +
wdv 	漠	*+
wdwf	湿	 +
wdx 	幼	*+
wdy 	幼	*+
wdy 	涅	 +
we  	武	*+
we  	巫	*+
wea 	浔	*+
weab	赟	*
weay	涔	*+
weaz	斌	 +
weda	鋈	*+
wede	洹	*+
wedf	添	 +
wedh	添	 +
wee 	丞	*+
wee 	净	 +
weev	濯	*+
wef 	烫	*+
wef 	荡	 +
weg 	滔	*+
weg 	韬	*+
wei 	汕	*+
weia	浔	 +
wej 	津	*+
wek 	淫	*+
wel 	沌	*+
wel 	浼	*+
wenu	浸	 +
weo 	酒	*+
wep 	汤	*+
wep 	卺	*+
weqa	涿	*+
weqd	潴	*+
wer 	湍	*+
wesi	泾	 +
wetr	湍	 +
wev 	巫	*+
wew 	渌	*+
wewd	溪	 +
wewf	沩	 +
wewy	湿	 +
wex 	孑	*+
wez 	浮	*+
we, 	ゑ	*+
we. 	ヱ	*+
wf  	添	*+
wfa 	乌	*+
wfa 	涛	 +
wfad	泪	 +
wfb 	邬	*+
wfbb	淤	*+
wfd 	澧	*+
wfdl	滟	*+
wfds	洁	 +
wff 	淡	*+
wffa	滢	*+
wffd	涝	*+
wffk	浓	 +
wffl	滟	*+
wffs	潆	*+
wfft	渠	*+
wfj 	游	 +
wfj 	沣	*+
wfk 	沔	*+
wfka	溽	*+
wfl 	汇	*+
wfn 	凑	*+
wfnc	浊	 +
wfnc	滟	 +
wfnd	凑	 +
wfnh	溱	*+
wfnl	滟	*+
wfnn	滞	*+
wfnn	凑	 +
wfo 	泗	*+
wfoc	沪	 +
wfol	沪	 +
wfoo	沤	*+
wfp 	沪	*+
wfs 	泺	*+
wfsu	淑	 +
wft 	柒	*+
wfu 	湖	*+
wfua	瀛	*+
wfuz	瀛	*+
wfvz	游	 +
wfvz	漩	 +
wfx 	泼	*+
wfx 	沤	*+
wfy 	泽	*+
wfyg	泽	 +
wg  	溉	*+
wgf 	盥	*+
wgi 	涅	*+
wgiu	溲	 +
wgj 	汗	*+
wgn 	沃	*+
wgn 	浃	*+
wgna	鋈	*+
wgnf	添	 +
wgnf	泻	 +
wgnh	添	 +
wgo 	活	*+
wgo 	泔	*+
wgo 	洳	*+
wgu 	溲	*+
wgw 	漆	*+
wgx 	汝	*+
wgy 	滂	*+
wh  	涂	*+
wha 	沁	*+
whds	洁	 +
whe 	齐	*+
whf 	湃	*+
whf 	湫	*+
whi 	渊	*+
whl 	港	*+
whmb	渍	*+
who 	渚	*+
whp 	泌	*+
whp 	渊	 +
whr 	剂	*+
whs 	斋	*+
whsu	潲	*+
whu 	清	*+
whv 	涂	 +
whx 	浚	*+
wi  	了	*+
wia 	溥	*+
wie 	江	*+
wif 	盗	*+
wigu	溲	 +
wih 	欲	*+
wij 	浦	*+
win 	欲	*+
winf	鸿	*+
wiq 	油	*+
wiqx	泄	 +
wirp	澉	*+
wisq	湾	 +
wist	滦	*+
wiu 	叏	*
wiw 	浒	*+
wiwu	幽	 +
wix 	泄	*+
wi, 	ゐ	*+
wi. 	ヰ	*+
wj  	午	*+
wj  	韦	*+
wjb 	滇	*+
wjbe	瀚	*+
wjcb	濑	 +
wjci	漱	*+
wjcs	涑	 +
wjd 	澄	*+
wjde	瀚	*+
wjdu	潮	 +
wje 	沟	*+
wjeg	凄	 +
wjg 	凄	*+
wjj 	汁	*+
wjj 	淬	*+
wjk 	浙	*+
wjm 	渎	*+
wjmb	滇	 +
wjn 	决	*+
wjn 	沛	 +
wjnd	渤	*+
wjny	沟	 +
wjo 	沽	*+
wjou	湖	 +
wjqu	泼	 +
wju 	潮	*+
wjyd	渎	 +
wk  	涨	*+
wka 	潢	*+
wka 	丸	 +
wkb 	淇	*+
wkbk	澌	*+
wkbl	湛	 +
wkbu	涵	 +
wke 	汪	*+
wke 	污	 +
wkeb	浜	*+
wki 	沂	*+
wkkd	潜	 +
wkl 	沈	*+
wkl 	湛	 +
wkl 	汽	 +
wklb	湛	 +
wklr	湛	 +
wkn 	丧	*+
wko 	减	*+
wkrl	湛	 +
wkt 	染	*+
wkv 	湛	*+
wkx 	浅	*+
wkz 	汽	*+
wl  	流	*+
wla 	潦	*+
wla 	漓	*+
wla 	洒	 +
wlb 	漉	*+
wlbf	濂	*+
wlbk	滚	 +
wld 	沥	*+
wldj	漳	*+
wle 	泣	*+
wleo	溏	*+
wlfq	湾	 +
wlft	滦	*+
wlhq	濠	*+
wlhz	沥	 +
wlhz	淳	 +
wlk 	派	*+
wll 	浐	*
wllb	洒	 +
wlm 	彦	*+
wlmb	颜	 +
wlmt	颜	 +
wln 	沛	*+
wln 	涞	*+
wlnf	滂	 +
wlno	滴	 +
wlnq	濠	*+
wlo 	涪	*+
wlo 	潞	*+
wloe	澶	*+
wlok	滚	 +
wlom	澶	*+
wloq	濠	*+
wlos	凉	 +
wloz	淳	 +
wlp 	产	 +
wlp 	汴	*+
wlp 	浐
wlps	源	 +
wlpu	液	 +
wlq 	潼	*+
wlq 	濂	*+
wlr 	沆	*+
wlrk	滚	 +
wlru	渡	 +
wls 	产	 +
wls 	凉	 +
wlsr	铲	 +
wlt 	澡	*+
wluk	滚	 +
wlul	泷	*+
wlw 	泫	*+
wlww	滋	 +
wlx 	液	*+
wlxu	漓	*+
wlyy	涯	*+
wlz 	淳	*+
wm  	海	*+
wmbf	溅	*+
wmbk	溅	*+
wmbq	溅	*+
wmbr	测	 +
wmcs	澜	 +
wmcs	斓	 +
wmd 	涧	*+
wme 	沮	*+
wmg 	溇	*+
wmgo	阔	*+
wmjs	澜	 +
wmjs	斓	 +
wmk 	润	*+
wmn 	澜	*+
wmn 	斓	*+
wmo 	泪	*+
wmq 	潘	*+
wmqb	瀵	*+
wmr 	渊	*+
wmr 	觋	*+
wms 	渺	*+
wmv 	澎	*+
wmv 	濉	*+
wmx 	漫	*+
wn  	水	*+
wn  	廴	*+
wna 	演	*+
wnb 	涫	*+
wnbi	澹	 +
wnbo	溶	 +
wnbt	深	 +
wnc 	浑	*+
wnc 	涣	*+
wncb	滨	 +
wncb	浜	 +
wncr	浼	*+
wnd 	洵	*+
wndl	溟	*+
wne 	渲	*+
wne 	净	 +
wneb	演	 +
wnee	渲	 +
wneo	洞	*+
wneq	沈	 +
wnez	淀	 +
wnf 	鹉	*+
wnf 	沱	*+
wnf 	鹆	*+
wnf 	鹀	*+
wnfb	涣	*+
wngf	泻	*+
wnht	泞	 +
wni 	淘	*+
wni 	渖	*+
wni 	沈	 +
wnii	渖	*+
wnii	沈	 +
wnk 	浓	*+
wnkb	滨	 +
wnke	泻	*+
wnkf	泻	*+
wnl 	泡	*+
wnl 	滓	*+
wnli	澹	 +
wnmq	沈	 +
wnmq	渖	 +
wnn 	深	 +
wnnd	涣	*+
wnol	泡	 +
wnpb	滨	 +
wnr 	沉	*+
wnr 	沈	 +
wnrr	浣	*+
wnrs	淙	 +
wnrt	深	 +
wns 	淙	*+
wns 	沵	*+
wnsb	滨	 +
wnsb	浜	 +
wnt 	泞	*+
wntb	演	 +
wnu 	沟	*+
wnu 	没	 +
wnw 	溶	*+
wnwu	淘	 +
wnx 	孓	*+
wnxu	汹	 +
wnz 	淀	*+
wo  	谷	*+
woar	浏	*+
wob 	泅	*+
wobf	温	 +
wod 	洇	*+
woea	溷	*+
woeq	溷	*+
woil	渑	*+
wojo	涸	*+
wol 	汜	*+
womb	涢	*
wonb	涡	 +
wonb	涢	 +
woo 	吾	*+
woo 	吝	 +
woo 	啬	*+
woo 	洄	*+
woot	澡	 +
wop 	潋	*+
woq 	溜	*+
woql	渑	*+
wor 	况	*+
wos 	韦	*+
wosa	韧	 +
wosd	韧	 +
wosf	韫	*+
wosg	韬	*+
wosw	违	 +
wosx	韧	 +
wou 	涓	*+
woue	亟	*+
wov 	吝	*+
wow 	涠	*+
wows	涠	 +
wox 	泯	*+
woz 	浞	*+
wozo	潞	*+
wo, 	を	*+
wo. 	ヲ	*+
wp  	乡	*+
wp  	激	*+
wpad	溴	*+
wpaq	浌	*+
wpaz	泛	 +
wpd 	泊	*+
wpd 	沃	 +
wpda	鋈	*+
wpdd	响	 +
wpdf	添	 +
wpdh	添	 +
wpdk	溉	 +
wpdk	湟	*+
wpdp	激	 +
wpdt	乐	 +
wpdt	泺	 +
wpf 	盈	*+
wpf 	洫	*+
wpfb	濮	*+
wpfd	濮	*+
wpg 	婆	*+
wpi 	却	 +
wpit	涤	 +
wpl 	泛	*+
wpm 	洎	*+
wpmd	溴	*+
wpmr	濞	*+
wpn 	涤	*+
wpnd	澳	 +
wpo 	洛	*+
wpo 	洎	 +
wpob	澳	 +
wpob	浜	 +
wpqr	濞	*+
wps 	洚	*+
wpt 	涤	*+
wpu 	汲	*+
wpv 	激	*+
wpv 	濮	*+
wpx 	波	*+
wpz 	泛	*+
wpzw	涎	*+
wq  	湾	*+
wqa 	溃	*+
wqb 	沫	*+
wqbb	溺	*+
wqdo	漪	*+
wqe 	里	 +
wqek	涨	 +
wqer	浇	 +
wqer	淠	*+
wqj 	淖	*+
wqmm	溺	*+
wqnd	潜	 +
wqo 	涡	*+
wqo 	畿	*+
wqr 	弥	*+
wqs 	漯	*+
wqu 	滑	*+
wqu 	渭	*+
wqu 	泓	*+
wqv 	浅	*+
wqv 	漪	*+
wqx 	泄	*+
wqyd	潴	*+
wr  	刘	*+
wr  	测	 +
wra 	洮	*+
wra 	泛	 +
wrar	漭	*+
wrb 	洪	*+
wrbb	洮	 +
wrbl	港	 +
wrbp	港	 +
wrc 	汉	*+
wrcv	滩	 +
wrdd	漠	 +
wrdr	漭	*+
wre 	灌	*+
wreb	满	 +
wreh	潇	*+
wren	浉	*+
wrer	潇	*+
wres	潇	*+
wrf 	滥	*+
wrfd	漕	*+
wri 	齐	*+
wri 	刘	 +
wri 	斋	 +
wriv	刘	 +
wrj 	洱	*+
wrk 	污	*+
wrm 	渊	*+
wrn 	汲	*+
wrn 	泺	 +
wrna	滢	*+
wrnb	满	 +
wrnd	涝	*+
wrnh	懑	*+
wrnq	蒙	 +
wrns	潆	*+
wro 	沿	*+
wrod	漕	*+
wrod	澧	 +
wrok	浓	 +
wrov	灌	 +
wrqb	潢	 +
wrr 	剂	*+
wrr 	沅	*+
wrre	齑	*+
wrrr	滠	*+
wrs 	渊	*+
wrse	齑	*+
wrt 	颒	*
wrtb	颒	 +
wrtn	浉	*
wru 	没	*+
wruu	滠	*+
wrv 	测	 +
wrvf	滥	 +
wrww	滋	 +
wrx 	浸	*+
wrx 	沨	*+
ws  	漂	*+
wsa 	紊	*+
wsb 	洙	*+
wsbb	承	 +
wsg 	娑	*+
wsh 	挲	*+
wsi 	泾	*+
wsiq	湾	 +
wsit	滦	*+
wsj 	承	*+
wsk 	湾	 +
wsl 	泄	*+
wslk	裟	*+
wsna	滢	*+
wsnd	涝	*+
wsnn	滞	*+
wsno	淌	*+
wso 	浩	*+
wsp 	沙	*+
wsq 	淄	*+
wsr 	洗	*+
wsr 	渊	 +
wss 	洙	*+
wst 	渫	*+
wsu 	消	*+
wsuf	鲨	*+
wsv 	潍	*+
wt  	深	*+
wt  	梁	*+
wtbu	淞	*+
wtbw	漆	 +
wtd 	涌	*+
wtde	渣	*+
wti 	汀	*+
wtj 	涌	*+
wtk 	淅	*+
wtly	沔	 +
wtm 	湘	*+
wtm 	渣	*+
wtn 	沐	*+
wtnd	涌	 +
wtnh	恿	 +
wtnq	涌	 +
wtnr	斋	 +
wto 	河	*+
wtoh	湎	*+
wtp 	涕	*+
wtqd	涌	 +
wtrp	澉	*+
wts 	流	 +
wtsa	鎏	*+
wtt 	淋	*+
wttg	漤	*+
wttk	浓	 +
wttu	潸	*+
wtup	澈	 +
wtv 	梁	*+
wtw 	漆	*+
wtx 	澈	*+
wu  	法	*+
wua 	汊	*+
wubb	淤	*+
wubp	浚	 +
wuc 	淝	*+
wucj	坛	 +
wucl	淝	 +
wudm	渗	 +
wuf 	渔	*+
wui 	函	*+
wui 	缸	*+
wui 	缶	*+
wui 	泾	 +
wui 	凼	*+
wuj 	缺	*+
wuj 	污	 +
wum 	渗	*+
wun 	泳	*+
wunu	离	 +
wunv	离	 +
wuo 	治	*+
wuq 	泽	*+
wur 	濡	*+
wur 	罐	*+
wurp	浚	 +
wuru	灞	*+
wurv	罐	*+
wut 	滪	*
wutb	滪	 +
wute	钵	 +
wutr	濡	 +
wuum	渗	 +
wuv 	滩	*+
wuv,	ぅ	*+
wuv.	ゥ	*+
wux 	汉	*+
wux 	坛	 +
wux 	叏	 +
wuy 	泾	*+
wuzh	罅	*+
wu, 	う	*+
wu, 	ぅ	*+
wu. 	ウ	*+
wu. 	ゥ	*+
wv  	辽	*+
wva 	沲	*+
wvb 	濑	*+
wve 	淮	*+
wvj 	沸	*+
wvj 	准	 +
wvo 	澹	*+
wvom	海	 +
wvs 	涑	*+
wvsb	濑	 +
wvsi	漱	*+
wvz 	汔	*+
ww  	滋	*+
ww  	斌	*+
wwa 	沩	*+
wwab	几	 +
wwaq	畿	*+
wwbu	涵	 +
wwe 	丝	*+
wwe 	幽	 +
wwe 	斌	 +
wwef	鸶	*+
wwek	断	 +
wwf 	丝	*+
wwff	鸶	*+
wwfk	断	 +
wwh 	济	*+
wwl 	浐	*+
wwm 	汤	*+
wwmb	赟	*+
wwmf	烫	 +
wwmf	荡	 +
wwn 	违	*+
wwn 	这	 +
wwn 	辽	 +
wwn 	迕	*+
wwo 	浴	*+
wwo 	浯	*+
wwpt	泺	 +
wwr 	济	*+
wwr 	浏	*+
wwu 	涵	*+
wwuu	漓	*+
www 	淼	*+
wwx 	汶	*+
wx  	文	*+
wxbd	渎	 +
wxj 	潭	*+
wxl 	淹	*+
wxl 	渑	*+
wxn 	飨	*+
wxo 	滴	*+
wxu 	汹	*+
wxu 	洧	*+
wxx 	淆	*+
wxxn	浠	*+
wxxu	淆	 +
wy  	洲	*+
wya 	源	*+
wyd 	渚	*+
wyda	澍	*+
wydm	澎	 +
wye 	溢	*+
wyen	浉	*
wyfb	渎	 +
wym 	渎	*+
wyo 	洁	*+
wyoa	澍	*+
wyom	澎	 +
wypd	渚	 +
wyr 	浇	*+
wys 	沫	*+
wytn	浉	*
wyu 	法	 +
wyuf	溘	 +
wyv 	涂	 +
wyy 	幻	*+
wyy 	洼	*+
wyya	涛	 +
wyyr	浇	 +
wyyy	洲	 +
wz  	游	*+
wza 	丸	 +
wzc 	泸	*+
wzce	瀣	*+
wzdj	淖	 +
wze 	滗	*+
wzh 	滤	*+
wzh 	滹	*+
wzj 	汛	*+
wzm 	滗	*+
wzmb	浈	*+
wznm	浚	 +
wzo 	沾	*+
wzoa	卤	 +
wzof	卤	 +
wzox	卤	 +
wzp 	卸	*+
wzqf	泸	 +
wzqh	滤	 +
wzs 	涉	*+
wzsb	濒	*+
wzst	濒	*+
wzv 	漩	*+
wzx 	汛	*+
wzx 	丸	 +
x   	有	*+
xa  	专	*+
xa  	飠	*+
xaa 	氐	*+
xaaf	鬯	*+
xab 	邸	*+
xaf 	饯	*+
xaja	馎	 +
xanf	鸱	*+
xao 	饸	*+
xaqq	饯	 +
xat 	馀	*+
xati	弑	 +
xatr	刹	 +
xatu	杀	 +
xa, 	ぁ	*+
xa. 	ァ	*+
xb  	窝	*+
xbd 	卖	*+
xbh 	馀	*+
xbhe	馐	*+
xbi 	邪	*+
xbi 	郁	 +
xbk 	饼	*+
xbke	馐	*+
xbko	膳	*+
xc  	蜜	*+
xca 	蚀	*+
xce 	馌	*
xceb	馈	 +
xd  	窃	*+
xdb 	馄	*+
xddq	馏	 +
xde 	饾	*+
xdfu	馒	 +
xdg 	馅	*+
xdnm	饧	 +
xdo 	昏	*+
xdv 	馍	*+
xe  	密	*+
xeb 	邸	*+
xeb 	馋	*+
xee 	氐	*+
xee 	饳	 +
xeg 	馁	*+
xeg 	馅	 +
xel 	饨	*+
xenf	鸱	*+
xeo 	饲	*+
xep 	饧	*+
xeu 	饳	*
xe, 	ぇ	*+
xe. 	ェ	*+
xf  	窄	*+
xff 	盔	*+
xflb	馔	*+
xfn 	灰	*+
xfuf	鬯	*+
xg  	藉	*+
xga 	瓠	*+
xgiu	馊	 +
xgl 	饦	*+
xgn 	饫	*+
xgu 	馊	*+
xh  	悲	*+
xhx 	馂	*
xi  	弑	*+
xia 	馎	*
xie 	左	*+
xigu	馊	 +
xin 	饮	*+
xix 	饿	*+
xiy 	在	 +
xiz 	存	 +
xi, 	ぃ	*+
xi. 	ィ	*+
xj  	升	*+
xj  	覃	*+
xjck	馕	*+
xjnz	饽	*+
xk  	徵	*+
xk  	夸	*+
xka.	ヵ	*+
xke 	饪	*+
xke.	ヶ	*+
xkl 	饩	*+
xkx 	饯	*+
xkz 	饩	*+
xl  	奄	*+
xld 	响	 +
xlk 	饻	*+
xlu 	饭	*+
xlx 	饺	*+
xm  	萨	*+
xmb 	质	*+
xmo 	盾	*+
xmw 	遁	*+
xmx 	馒	*+
xn  	食	*+
xnb 	馆	*+
xncb	馋	*+
xnf 	鸦	*+
xnf 	鹌	*+
xng 	馅	*+
xni 	布	*+
xnj 	布	*+
xnj 	纸	 +
xnl 	饱	*+
xnl 	匏	*+
xnoa	馋	*+
xnol	饱	 +
xnol	匏	 +
xo  	商	*+
xo  	饷	*+
xolb	馔	*+
xoo 	右	*+
xoq 	馏	*+
xov 	饷	*+
xo, 	ぉ	*+
xo. 	ォ	*+
xp  	牙	*+
xpd 	饫	*+
xpno	饷	 +
xpno	向	 +
xpo 	饹	*+
xpqu	馈	 +
xpx 	敌	*+
xq  	窗	*+
xqa 	馈	*+
xqer	饶	 +
xqk 	喂	*+
xqt 	馃	*+
xqu 	馉	*+
xr  	微	*+
xrc 	馑	*+
xrdd	馍	 +
xri 	刈	*+
xri 	刳	*+
xrj 	饵	*+
xrl 	饥	*+
xrup	馓	*+
xrz 	饥	*+
xs  	徽	*+
xt  	窠	*+
xta 	杀	*+
xtai	弑	 +
xtde	馇	 +
xti 	饤	*+
xtm 	馇	*+
xtn 	杀	*+
xtr 	刹	*+
xtru	杀	 +
xtu,	っ	*+
xtu.	ッ	*+
xu  	淑	*+
xub 	郁	*+
xue 	有	 +
xui 	凶	*+
xuo 	饴	*+
xur 	凶	*+
xurp	馂	 +
xuv 	雄	*+
xux 	友	*+
xu, 	ぅ	*+
xu. 	ゥ	*+
xv  	营	*+
xva 	馈	*+
xvd 	饬	*+
xve 	雅	*+
xvn 	饰	*+
xvnk	馕	*+
xw  	随	*+
xwa,	ゎ	*+
xwa.	ヮ	*+
xwb 	饥	*+
xwm 	饧	*+
xwn 	适	*+
xwn 	迓	*+
xwwb	饥	 +
xx  	氏	*+
xx  	乄	*+
xxe 	肴	*+
xxn 	希	*+
xxnb	郗	*+
xxni	欷	*+
xxu 	肴	*+
xxub	郄	*+
xxx 	爻	*+
xxxu	肴	 +
xxzp	教	 +
xy  	在	*+
xya,	ゃ	*+
xya.	ャ	*+
xyeo	饲	 +
xye,	ぇ	*
xye.	ェ	*
xyi,	ぃ	*
xyi.	ィ	*
xyo,	ょ	*+
xyo.	ョ	*+
xyr 	饶	*+
xyuf	馌	 +
xyu,	ゅ	*+
xyu.	ュ	*+
xyyr	饶	 +
xz  	存	*+
y   	土	*+
ya  	原	*+
yaa 	寺	*+
yajq	埔	 +
yakp	垅	*+
yal 	地	*+
yal 	垅	*+
yan 	埃	*+
yao 	垢	*+
yaqe	域	 +
yaqn	城	 +
yaqy	城	 +
yav,	ゃ	*+
yav.	ャ	*+
yaxf	垅	*+
yay 	城	*+
yayh	埝	*+
ya, 	や	*+
ya, 	ゃ	*+
ya. 	ヤ	*+
ya. 	ャ	*+
yb  	都	*+
yba 	坏	*+
ybd 	买	 +
ybe 	坯	*+
ybg 	幸	 +
ybgb	贽	*+
ybgc	蛰	 +
ybgf	鸷	*+
ybgh	挚	 +
ybgs	絷	 +
ybgu	报	 +
ybgw	达	 +
ybgy	垫	 +
ybgz	执	 +
ybhw	达	 +
ybi 	邪	*+
ybk 	丧	*+
ybo 	增	*+
ybqd	增	 +
ybv 	坟	*+
ybyd	势	 +
ybyf	热	 +
ybyw	逵	*+
ybyy	垫	 +
yc  	声	*+
ycee	堀	*+
yceu	堀	*+
ycf 	坭	*+
ycp 	声	 +
ycrd	馨	 +
ycre	罄	 +
ycri	謦	*+
ycro	磬	*+
ycrr	声	 +
ycru	罄	 +
ycws	墀	*+
ycy 	堙	*+
yd  	者	*+
yda 	埘	*+
ydb 	都	 +
yddo	嘉	 +
yde 	坦	*+
ydee	塌	*+
ydee	翥	 +
ydem	场	 +
ydez	堤	 +
ydf 	煮	*+
ydfu	墁	 +
ydil	埯	 +
ydjb	冬	 +
ydjg	鼙	*+
ydjm	瞽	*+
ydju	鼓	 +
ydk 	垠	*+
ydm 	彭	*+
ydmw	甏	*+
ydnm	埸	*+
ydo 	喜	*+
ydo 	者	 +
ydof	熹	*+
ydql	埯	 +
ydrk	垮	 +
ydw 	垯	*+
ydya	埘	 +
ydzu	鼓	 +
ye  	士	*+
ye  	土	 +
yea 	埒	*+
yed 	垲	*+
yede	垣	*+
yee 	归	*+
yee 	刁	*+
yefe	垭	 +
yefl	垲	 +
yei 	击	 +
yej 	埽	*+
yen 	师	*+
yenn	埽	 +
yeo 	司	 +
yeot	塥	*+
yep 	场	*+
yep 	埸	*+
yev 	土	 +
yew 	埭	*+
yf  	盐	*+
yf  	熬	*+
yfa 	赤	*+
yfb 	郝	*+
yfdg	堰	*+
yff 	塄	*+
yfh 	赭	*+
yfl 	圮	*+
yfmb	卖	 +
yfmr	觌	*+
yfnc	蠲	*+
yfo 	垢	*+
yfp 	赦	*+
yfp 	敖	 +
yfpa	鏊	*+
yfpb	赘	*+
yfpc	螯	*+
yfpc	螫	*+
yfpd	獒	*+
yfpf	熬	 +
yfpf	鳌	 +
yfpf	骜	*+
yfpr	聱	*+
yfpu	赧	*+
yfpw	遨	*+
yfpx	鳌	*+
yfv 	熬	*+
yfy 	坊	*+
yfyd	赭	 +
yfyf	赫	*+
yfzb	赪	*+
yg  	赶	*+
ygo 	坩	*+
ygqf	埙	*+
yh  	愿	*+
yha 	志	*+
yha 	愿	 +
yha 	埘	 +
yhd 	馨	*+
yhe 	域	*+
yho 	堵	*+
yi  	款	*+
yi  	丫	*+
yii 	坤	*+
yij 	埔	*+
yin 	坎	*+
yiqi	坤	 +
yiv 	款	 +
yizg	芈	 +
yj  	幸	*+
yja 	坟	*+
yjb 	填	*+
yjbo	墙	*+
yje 	埴	*+
yjl 	埴	*+
yjmb	填	 +
yjme	埴	 +
yjml	埴	 +
yjn 	块	*+
yjn 	堤	 +
yjrb	坟	 +
yk  	壤	*+
yka 	坼	*+
yka 	执	 +
ykad	势	 +
ykaf	热	 +
ykbl	堪	 +
yki 	圻	*+
ykl 	堪	*+
yklb	堪	 +
yklr	堪	 +
ykrl	堪	 +
ykv 	堪	*+
yl  	起	*+
yld 	坜	*+
yldr	境	 +
yle 	垃	*+
yleo	塘	*+
yleq	墉	*+
ylfk	坏	 +
ylfq	塆	*+
ylh 	垓	*+
ylhp	墩	*+
ylhq	壕	 +
ylhz	坜	 +
ylk 	圹	*+
yll 	乜	*+
yln 	壤	 +
ylno	墒	 +
ylnq	壕	 +
ylo 	培	*+
ylo 	磬	*+
yloe	坛	 +
ylok	壤	 +
ylom	坛	 +
ylop	墩	*+
yloq	壕	 +
ylp 	圹	*+
ylps	塬	*+
ylr 	坑	*+
ylrb	圹	 +
ylu 	坂	*+
ylul	垅	*+
ylxu	垴	*+
ylzp	墩	*+
ym  	趁	*+
yma 	卖	*+
ymb 	坝	*+
ymmr	觌	*+
ymv 	彭	*+
ymx 	墁	*+
yn  	院	*+
yn  	乁	*+
ynae	坍	 +
ynb 	均	*+
ynca	堍	*+
yncu	毂	*+
ynd 	壹	*+
yndh	懿	*+
ynea	冢	*+
ynee	壶	 +
yneo	垌	*+
yneq	冢	*+
yner	壳	*+
yneu	壳	*+
yneu	谷	 +
yneu	毂	 +
yneu	彀	 +
ynex	冢	*+
ynf 	鸦	*+
ynf 	壹	 +
ynf 	坨	*+
ynf 	鹢	*
ynfe	壶	 +
ynhu	谷	 +
yni 	帅	*+
ynj 	帅	*+
ynl 	坍	*+
ynnu	觳	*+
yno 	壶	*+
ynqu	彀	*+
ynr 	均	*+
ynr 	壳	*+
ynr 	卖	 +
ynrh	悫	*+
ynrr	垸	*+
ynru	壳	*+
yo  	超	*+
yo  	嘉	 +
yobf	熹	*+
yobg	鼙	*+
yobm	彭	 +
yobm	瞽	 +
yobo	嘉	 +
yobo	喜	 +
yobu	鼓	 +
yobw	甏	*+
yoe 	垭	*+
yok 	袁	*+
yok 	埕	*+
yokw	远	 +
yol 	圯	*+
yom 	坶	*+
yomb	埙	*+
yonb	埚	 +
yonp	台	 +
yoo 	吉	*+
yorf	熹	*+
yoro	喜	 +
yoro	嘉	 +
yot 	颉	*+
yotb	颉	 +
yov 	嘉	 +
yov,	ょ	*+
yov.	ョ	*+
yo, 	よ	*+
yo, 	ょ	*+
yo. 	ヨ	*+
yo. 	ョ	*+
yp  	却	*+
yp  	敖	*+
ypab	都	 +
ypad	者	 +
ypae	翥	*+
ypaf	煮	 +
ypbj	埠	*+
ypd 	者	 +
ypdb	都	 +
ypde	翥	*+
ypdf	煮	 +
ypdr	睹	 +
ype 	垤	*+
ypf 	老	*+
ypf 	盐	 +
ypfd	耆	*+
ypfd	堠	*+
ypfm	耄	*+
ypfp	耋	*+
ypg 	埤	*+
ypj 	坪	*+
ypk 	考	 +
ypno	垧	*+
ypqg	埤	 +
ypqu	块	 +
ypu 	圾	*+
ypu 	报	 +
ypv 	敖	*+
ypx 	坡	*+
ypz 	孝	*+
ypzp	教	 +
ypzw	埏	*+
yq  	嘉	*+
yqe 	埋	*+
yqi 	厣	*+
yqo 	埚	*+
yqv 	壕	*+
yr  	境	*+
yrao	塔	 +
yree	翘	*+
yrj 	声	 +
yrk 	圬	*+
yrl 	尧	*+
yrl 	圥	*+
yrn 	圾	*+
yro 	塔	*+
yrsi	款	 +
yrsw	隶	*+
yrt 	垛	*+
yryd	势	 +
yryf	热	 +
yryw	逵	*+
yryy	垫	 +
ys  	末	*+
ys  	疏	*+
yse 	垱	*+
ysi 	圳	*+
ysn 	未	*+
ysn 	末	 +
yspg	嫠	*+
yspq	厘	*+
ysps	犁	 +
yst 	堞	*+
ysv 	疏	*+
yt  	趋	*+
yta 	坛	*+
yta 	愿	 +
ytmb	愿	 +
ytn 	师	*+
yto 	坷	*+
ytoh	靥	*+
ytqx	埂	 +
ytx 	埂	*+
yu  	趣	*+
yu  	鼓	*+
yua 	去	*+
yua 	埒	 +
yud 	劫	*+
yuf 	盍	*+
yuj 	圩	*+
yup 	却	 +
yuru	坝	 +
yuu 	堋	*+
yuv 	鼓	*+
yuvd	埃	 +
yuv,	ゅ	*+
yuv.	ュ	*+
yuw 	迲	*+
yu, 	ゆ	*+
yu, 	ゅ	*+
yu. 	ユ	*+
yu. 	ュ	*+
yv  	越	*+
yva 	块	*+
yva 	魇	*+
yve 	堆	*+
yve 	雅	 +
yvof	盐	 +
yvq 	芈	*+
yvz 	圪	*+
yw  	药	*+
ywd 	坳	*+
ywdt	墚	*+
ywf 	坞	*+
ywm 	场	*+
ywm 	埸	*+
ywn 	达	*+
ywn 	逵	*+
ywn 	迓	*+
ywoo	墙	*+
ywu 	罄	*+
ywu 	垴	*+
ywx 	坟	*+
yx  	赵	*+
yxa 	坻	*+
yxe 	坻	*+
yxk 	垮	*+
yxl 	埯	*+
yxn 	餍	*+
yxo 	墒	*+
yy  	州	*+
yy  	乀	*
yy  	乁	*
yy  	乛	*+
yya 	封	*+
yya 	塬	*+
yyan	帮	 +
yyd 	堵	*+
yye 	圭	*+
yye 	压	 +
yyh 	恚	*+
yyia	寿	 +
yyif	焘	 +
yyp 	卦	*+
yypd	堵	 +
yyy 	州	 +
yyye	翘	*+
yyyr	尧	 +
yz  	堤	*+
yza 	执	*+
yzaf	越	 +
yzai	越	 +
yzap	越	 +
yzbi	趑	*+
yzbm	趁	 +
yzc 	蛋	*+
yzc 	蛰	 +
yzc 	垆	*+
yzd 	势	*+
yzdg	赶	 +
yzdo	超	 +
yzdr	趔	*+
yze 	址	*+
yze 	归	 +
yzen	归	 +
yzf 	热	*+
yzfe	墟	*+
yzfl	起	 +
yzg 	赶	 +
yzg 	赳	*+
yzh 	挚	*+
yzm 	趄	*+
yzmb	贽	*+
yzn 	走	*+
yzn 	疋	*+
yzne	趋	 +
yznf	鸷	*+
yzo 	坫	*+
yzol	起	 +
yzp 	赴	*+
yzq 	芈	*+
yzru	趣	 +
yzs 	絷	*+
yzsb	趱	*+
yzso	趟	*+
yzsu	赵	 +
yzts	疏	 +
yzu 	胥	*+
yzx 	赵	 +
yzx 	执	 +
yzy 	垫	*+
z   	整	*+
za  	舟	*+
za  	丸	 +
zaaf	篯	*+
zac 	签	*+
zado	舱	 +
zadp	节	 +
zae 	签	*+
zaf 	笺	*+
zakp	笼	 +
zal 	笼	*+
zao 	答	*+
zaob	签	 +
zaob	吁	 +
zaom	龠	*+
zaot	吁	 +
zap 	节	*+
zaqo	箴	 +
zaqq	笺	 +
zaqs	岁	 +
zase	签	 +
zax 	舣	*+
zaxf	笼	 +
za, 	ざ	*+
za. 	ザ	*+
zb  	频	*+
zba 	飞	*+
zbbe	签	 +
zbe 	簦	*+
zber	箭	 +
zbi 	箭	*+
zbj 	筚	*+
zbk 	筌	*+
zbl 	舭	*+
zbo 	船	*+
zbp 	舱	*+
zbqj	箪	 +
zbtm	艏	*+
zbu 	齿	*+
zbua	龄	 +
zbuf	龀	 +
zbuf	龇	 +
zbuk	龈	*+
zbuk	龂	*+
zbul	龅	 +
zbum	龃	 +
zbun	龅	 +
zbuo	龆	*+
zbuo	龉	 +
zbup	龄	 +
zbup	龌	 +
zbuu	龋	*+
zbuz	龊	*+
zbuz	龁	*+
zbx 	舣	*+
zc  	侦	*+
zca 	虱	*+
zca 	餐	 +
zcc 	虱	*+
zcdj	簟	 +
zceb	篑	 +
zceq	篆	 +
zci 	舯	*+
zcj 	舯	*+
zcl 	笆	*+
zcm 	艉	*+
zcnf	鸬	*+
zco 	舾	*+
zcp 	卢	*+
zcp 	范	 +
zct 	颅	*+
zct 	篥	*+
zctb	颅	 +
zcum	粲	*+
zcux	餐	 +
zcx 	餐	 +
zd  	籍	*+
zdaq	戏	 +
zde 	笪	*+
zdj 	卓	*+
zdkf	簋	*+
zdo 	笤	*+
zdo 	笳	*+
zdt 	桌	*+
zdup	节	 +
zdw 	笾	*+
zdx 	虏	*+
zdy 	虏	*+
ze  	止	*+
zed 	笑	*+
zee 	虐	*+
zee 	筝	 +
zeev	筝	 +
zeh 	箫	*+
zei 	舢	*+
zei 	笊	 +
zej 	笔	*+
zen 	笊	*+
zeod	献	 +
zeq 	篆	*+
zeqr	剧	 +
zeqw	遽	 +
zers	箫	 +
zes 	孙	*+
zesr	箫	 +
zesw	逊	 +
zex 	笋	*+
ze, 	ぜ	*+
ze. 	ゼ	*+
zf  	盘	*+
zfa 	筹	*+
zfaa	篾	*+
zfab	篾	*+
zfav	篾	*+
zfc 	箩	*+
zfd 	勐	*+
zfe 	虚	*+
zfe 	孟	 +
zfe 	盘	 +
zfeq	戏	 +
zfer	盘	 +
zfer	觑	*+
zfg 	箧	*+
zfi 	訾	*+
zfk 	筐	*+
zfl 	此	 +
zflo	砦	*+
zfm 	篇	*+
zfmb	赀	*+
zfn 	觜	*+
zfo 	笸	*+
zfpr	篼	*+
zfr 	些	 +
zfrs	篚	*+
zfs 	紫	*+
zfsv	箩	 +
zft 	柴	*+
zfv 	雌	*+
zfvd	簇	*+
zfy 	舫	*+
zg  	孤	*+
zga 	孤	 +
zgi 	节	*+
zgiu	艘	 +
zgj 	竿	*+
zgn 	笑	*+
zgn 	孤	 +
zgu 	艘	*+
zh  	孩	*+
zha 	虑	*+
zhj 	筷	*+
zhmb	箦	*+
zho 	箸	*+
zho 	艏	*+
zhu 	箐	*+
zi  	竹	*+
zib 	筇	*+
zie 	舡	*+
zigu	艘	 +
ziq 	笛	*+
ziq 	舳	*+
ziqr	箅	 +
zira	筑	 +
zirt	筑	 +
ziv,	ぢ	*+
ziv.	ヂ	*+
ziz 	筑	 +
zizt	筑	 +
zi, 	じ	*+
zi, 	ぢ	*+
zi. 	ジ	*+
zi. 	ヂ	*+
zj  	子	*+
zjc 	筢	*+
zjcb	籁	 +
zjcc	虱	 +
zjci	簌	*+
zjcl	筢	 +
zjd 	簦	*+
zjdq	籀	*+
zje 	篝	*+
zjfg	箨	*+
zjfn	箍	*+
zjfy	箨	*+
zjg 	箝	*+
zjn 	策	 +
zjns	策	 +
zjny	篝	 +
zjo 	筘	*+
zjod	箉	*+
zjoq	籀	*+
zjp 	笫	*+
zju 	歧	*+
zjuq	箨	*+
zjw 	迅	*+
zk  	测	*+
zka 	簧	*+
zkb 	箕	*+
zkbp	簸	*+
zkj 	笄	*+
zkkd	簪	*+
zko 	箴	*+
zkw 	艇	*+
zkx 	笺	*+
zl  	此	*+
zl  	虍	*+
zla 	篱	*+
zlb 	簏	*+
zlbf	帘	 +
zldk	蓑	*+
zle 	笠	*+
zlh 	孩	 +
zlho	篙	 +
zll 	孔	*+
zlmk	簖	*+
zlno	篙	 +
zloo	篙	 +
zlpq	帘	 +
zlq 	帘	*+
zlq 	艟	*+
zlr 	航	*+
zlrd	籍	 +
zlu 	舨	*+
zlul	笼	 +
zlw 	舷	*+
zlxu	篱	 +
zlxv	篱	 +
zlzr	篪	*+
zm  	舰	*+
zmb 	贞	*+
zmd 	简	*+
zmds	纂	*+
zmdu	篡	*+
zmf 	笃	*+
zmg 	篓	*+
zml 	笔	*+
zmlk	簖	*+
zmr 	算	*+
zmr 	舰	 +
zmr 	笕	*+
zmu 	齿	*+
zn  	餐	*+
znb 	管	*+
znbb	篦	*+
znbi	箜	*+
znbi	檐	 +
znbm	睿	*+
znby	壑	*+
zncp	箢	*+
znd 	笋	*+
zne 	筝	*+
znem	睿	*+
zneo	筒	*+
zney	壑	*+
znf 	舵	*+
znf 	鸼	*+
znfl	孢	 +
znl 	孢	*+
znli	檐	 +
znm 	笏	*+
zno 	笱	*+
znol	孢	 +
znq 	处	*+
znri	箜	*+
zo  	店	*+
zoa 	签	*+
zoaq	战	 +
zod 	点	 +
zoed	虞	*+
zof 	点	 +
zof 	卣	*+
zogn	虞	*+
zoj 	箪	*+
zojo	个	 +
zokb	虞	*+
zokd	虞	*+
zol 	乩	*+
zomb	筼	*+
zomr	觇	*+
zoo 	占	*+
zooj	箪	 +
zox 	卤	*+
zoxa	卤	 +
zoxb	硷	 +
zoxf	卤	 +
zoxi	鹾	*+
zoxk	咸	 +
zoxo	咸	 +
zo, 	ぞ	*+
zo. 	ゾ	*+
zp  	第	*+
zpa 	符	*+
zpaq	筏	*+
zpbn	筛	*+
zpd 	舶	*+
zpd 	笑	 +
zpdk	篁	*+
zpdr	篼	*+
zpfd	篌	*+
zpfw	篷	*+
zpg 	箅	*+
zpi 	节	*+
zpip	筱	 +
zpit	筱	 +
zpn 	筱	*+
zpob	篦	*+
zpqg	箅	 +
zpr 	处	*+
zps 	孙	*+
zpsw	逊	 +
zpu 	笈	*+
zpx 	孜	*+
zpzw	筵	*+
zq  	战	*+
zqa 	篑	*+
zqd 	虏	*+
zqer	箅	 +
zqf 	卢	*+
zqfb	颅	 +
zqft	颅	 +
zqh 	虑	*+
zqip	第	 +
zqj 	筚	*+
zqjq	筚	 +
zqo 	篙	*+
zqp 	第	 +
zqu 	肤	*+
zr  	些	*+
zr  	舰	 +
zre 	竺	*+
zreb	簧	 +
zren	筛	*+
zrf 	篮	*+
zrf 	舰	 +
zrfd	艚	*+
zri 	剧	 +
zrl 	虎	*+
zrm 	彪	*+
zrn 	笈	*+
zrnq	艨	*+
zro 	船	*+
zro 	箬	*+
zrod	艚	*+
zru 	般	 +
zruf	盘	 +
zruo	磐	*+
zrut	盘	 +
zrvf	篮	 +
zrvf	舰	 +
zrxo	箬	*+
zrz 	虎	*+
zs  	策	*+
zsa 	孙	*+
zse 	笙	*+
zse 	筜	*+
zsp 	步	*+
zsr 	筅	*+
zst 	频	 +
zstb	频	 +
zstg	颦	*+
zsu 	筲	*+
zsu 	艄	*+
zsw 	逊	*+
zt  	龄	*+
zte 	笨	*+
ztm 	箱	*+
zto 	舸	*+
ztp 	第	 +
ztqx	筻	 +
ztx 	筻	*+
zu  	般	*+
zuap	龄	 +
zuat	龄	 +
zub 	齿	*+
zubw	藤	*+
zucp	龌	*+
zud 	筋	*+
zudk	龈	*+
zudo	龆	*+
zue 	肯	*+
zuf 	龀	*+
zui 	齿	*+
zuj 	竽	*+
zum 	龃	*+
zun 	龅	*+
zunl	龅	 +
zuno	出	 +
zuo 	笞	*+
zuoz	龊	*+
zupu	龋	*+
zur 	孺	*+
zutr	孺	 +
zuv,	づ	*+
zuv.	ヅ	*+
zuwo	龉	*+
zux 	攴	*+
zuzf	龇	*+
zu, 	ず	*+
zu, 	づ	*+
zu. 	ズ	*+
zu. 	ヅ	*+
zv  	孟	*+
zvb 	籁	*+
zvf 	笮	*+
zvf 	舴	*+
zvo 	檐	*+
zvrk	亏	 +
zvsb	籁	 +
zvsi	簌	*+
zw  	遽	*+
zwaa	簿	*+
zwe 	筮	*+
zwia	簿	*+
zwn 	迅	*+
zwn 	遽	 +
zwpd	箔	*+
zwuu	篱	 +
zwuv	篱	 +
zwx 	虔	*+
zx  	丸	*+
zx  	孑	*+
zx  	孓	*+
zxcc	虱	 +
zxj 	簟	*+
zxw 	迅	*+
zy  	塑	*+
zya 	等	*+
zyd 	箸	*+
zyen	筛	*+
zyeo	笥	*+
zynb	筠	*+
zynr	筠	*+
zypd	箸	 +
zyya	筹	 +
zz  	乙	*+
zzc 	舻	*+
zzf 	艋	*+
,   	，	*+
,a  	α	*+
,a  	А	*+
,a  	а	*+
,a  	ɑ	*+
,a  	ㄚ	*+
,a  	．	*+
,a  	∀	*+
,ae 	亼	*+
,ae 	钅	*+
,ai 	ㄞ	*+
,air	✈	*+
,aj 	钅	*+
,al 	钅	*+
,al 	♢	*+
,al 	♦	*+
,all	∀	*+
,alp	Α	*+
,am 	㏂	*+
,an 	ㄢ	*+
,ang	ㄤ	*+
,ao 	ㄠ	*+
,apc	℀	*+
,aps	℁	*+
,au 	ㄠ	*+
,au 	㍳	*+
,a.m	㏂	*+
,b  	８	*+
,b  	Ⅷ	*+
,b  	β	*+
,b  	Ь	*+
,b  	ㄅ	*+
,b  	∞	*+
,bah	฿	*+
,bar	㍴	*+
,bb 	☯	*+
,bd 	✁	*+
,bd 	✂	*+
,bd 	✃	*+
,bd 	✄	*+
,be 	冫	*+
,be 	Б	*+
,be 	б	*+
,be 	Ё	*+
,be 	ё	*+
,bet	Β	*+
,bi 	阝	*+
,bi 	฿	*+
,bis	♗	*+
,bis	♝	*+
,bn 	㆟	*+
,bob	¤	*+
,bq 	㏃	*+
,bs 	☼	*+
,bs 	☉	*+
,bs 	☀	*+
,bu 	ü	*+
,bue	㋇	*+
,by 	☯	*+
,by 	☰	*+
,by 	☱	*+
,by 	☲	*+
,by 	☳	*+
,by 	☴	*+
,by 	☵	*+
,by 	☶	*+
,by 	☷	*+
,b. 	⒏	*+
,c  	７	*+
,c  	Ⅶ	*+
,c  	ㄘ	*+
,cal	㎈	*+
,cap	∩	*+
,cc 	ℂ	*+
,cd 	㏅	*+
,ce 	₠	*+
,cen	¢	*+
,ch 	ㄔ	*+
,che	Ч	*+
,che	ч	*+
,che	✓	*+
,che	✔	*+
,chi	Χ	*+
,chi	χ	*+
,chi	ㄔ	*+
,ci 	㆗	*+
,ci 	¢	*+
,ci 	ℂ	*+
,cj 	㆗	*+
,ckg	㏆	*+
,cl 	℄	*+
,clu	♣	*+
,clu	♧	*+
,cm 	₡	*+
,cmm	㎠	*+
,cmm	㎤	*+
,cmr	㎠	*+
,cms	㎤	*+
,co 	㏇	*+
,col	₡	*+
,com	☄	*+
,con	∮	*+
,co.	㏇	*+
,cp 	￠	*+
,cp 	¢	*+
,cpb	⅞	*+
,cpk	㏆	*+
,cpo	℅	*+
,cpu	℆	*+
,cr 	€	*+
,cr 	₢	*+
,cro	✙	*+
,cro	✚	*+
,cro	✛	*+
,cro	✜	*+
,cro	✝	*+
,cro	✞	*+
,cro	✟	*+
,cro	✠	*+
,cro	☩	*+
,cru	₢	*+
,cue	㋆	*+
,cup	∪	*+
,c. 	⒎	*+
,d  	δ	*+
,d  	ㄉ	*+
,da 	㍲	*+
,db 	捌	*+
,db 	☼	*+
,db 	☉	*+
,db 	☀	*+
,db 	㏈	*+
,dc 	柒	*+
,dc 	ↁ	*+
,de 	壹	*+
,de 	Д	*+
,de 	д	*+
,de 	㍽	*+
,del	Δ	*+
,df 	肆	*+
,dg 	【	*+
,dg 	】	*+
,dgg	】	*+
,dh 	㍼	*+
,di 	≯	*+
,dia	♢	*+
,dia	♦	*+
,dj 	拾	*+
,dk 	玖	*+
,dl 	陆	*+
,dl 	㎗	*+
,do 	零	*+
,do 	☼	*+
,do 	☉	*+
,do 	☀	*+
,dol	$	*+
,don	₫	*+
,dp 	₯	*+
,dr 	贰	*+
,dr 	₫	*+
,dra	₯	*+
,ds 	叁	*+
,ds 	★	*+
,ds 	☆	*+
,ds 	✩	*+
,ds 	✪	*+
,ds 	✫	*+
,ds 	✬	*+
,ds 	✭	*+
,ds 	✮	*+
,ds 	✯	*+
,ds 	✰	*+
,ds 	✡	*+
,dse	★	*+
,dse	☆	*+
,dse	✩	*+
,dse	✪	*+
,dse	✫	*+
,dse	✬	*+
,dse	✭	*+
,dse	✮	*+
,dse	✯	*+
,dse	✰	*+
,dse	✡	*+
,dt 	☯	*+
,dw 	伍	*+
,dw 	㍾	*+
,e  	１	*+
,e  	Ⅰ	*+
,e  	━	*+
,e  	ε	*+
,e  	∑	*+
,e  	∈	*+
,e  	－	*+
,e  	￣	*+
,e  	Э	*+
,e  	э	*+
,e  	ㄜ	*+
,e  	ㄝ	*+
,e  	─	*+
,e  	㆒	*+
,e  	∃	*+
,ea 	ā	*+
,ear	☷	*+
,eb.	⒙	*+
,ec.	⒘	*+
,ed 	㆝	*+
,ede	₫	*+
,edn	㆝	*+
,ee 	彐	*+
,ee 	＿	*+
,ee 	ˉ	*+
,ee 	—	*+
,ee 	－	*+
,ee 	￣	*+
,ee 	ē	*+
,ee 	─	*
,eee	┄	*+
,eee	┅	*+
,eee	┈	*+
,eee	┉	*+
,eee	☰	*+
,eer	☴	*+
,eeu	㋊	*+
,ee.	⒒	*+
,ef 	Ф	*+
,ef 	ф	*+
,ef.	⒕	*+
,eh 	ㄝ	*+
,eh 	♥	*+
,eh 	♡	*+
,eh 	❤	*+
,eh 	❥	*+
,eh 	❦	*+
,eh 	❧	*+
,ei 	屮	*+
,ei 	ī	*+
,ei 	ㄟ	*+
,ei 	∉	*+
,ei 	乀	*
,ei 	乁	*
,ej 	屮	*+
,ej 	肀	*+
,ej 	∓	*+
,ek.	⒚	*+
,el 	τ	*+
,el 	Л	*+
,el 	л	*+
,el 	ㄦ	*+
,el.	⒗	*+
,em 	М	*+
,em 	м	*+
,en 	Н	*+
,en 	н	*+
,en 	ㄣ	*+
,enb	㆛	*+
,eng	ㄥ	*+
,env	✉	*+
,eo 	ō	*+
,eou	㋉	*+
,eo.	⒑	*+
,ep 	⅟	*+
,ep 	∉	*+
,epb	⅛	*+
,epf	¼	*+
,epl	⅙	*+
,epr	½	*+
,eps	Ε	*+
,eps	⅓	*+
,epw	⅕	*+
,eq 	豸	*+
,er 	π	*+
,er 	∏	*+
,er 	Р	*+
,er 	р	*+
,er 	ㄦ	*+
,ere	☲	*+
,err	☶	*+
,eru	㋋	*+
,er.	⒓	*+
,es 	ξ	*+
,es 	С	*+
,es 	с	*+
,es.	⒔	*+
,eta	Η	*+
,eta	η	*+
,eu 	ū	*+
,eue	㋀	*+
,eur	€	*+
,eur	₠	*+
,ew.	⒖	*+
,ez 	→	*+
,ezz	↠	*+
,e. 	⒈	*+
,f  	４	*+
,f  	Ⅳ	*+
,f  	♀	*+
,f  	ㄈ	*+
,f  	㆕	*+
,fa 	灬	*+
,fa 	∷	*+
,fa 	㆘	*+
,fa 	☟	*+
,fac	☹	*+
,fac	☺	*+
,fac	☻	*+
,fb 	✙	*+
,fb 	✚	*+
,fe 	㆖	*+
,fe 	☝	*+
,fg 	✈	*+
,fgy	✈	*+
,fir	☲	*+
,fl 	ㄈ	*+
,fl 	匚	*+
,fm 	㎙	*+
,fn 	□	*+
,fn 	■	*+
,fn 	◇	*+
,fn 	◆	*+
,fn 	＊	*+
,fpw	⅘	*+
,fqu	☽	*+
,fqu	☾	*+
,fr 	₣	*+
,fra	₣	*+
,ft 	✈	*+
,fty	✈	*+
,fu 	∴	*+
,fue	㋃	*+
,fy 	♢	*+
,fy 	♦	*+
,f. 	⒋	*+
,g  	（	*+
,g  	）	*+
,g  	γ	*+
,g  	〔	*+
,g  	〖	*+
,g  	ɡ	*+
,g  	ㄍ	*+
,g  	巜	*
,ga 	ㄍ	*+
,ga 	⒜	*+
,gae	㈮	*+
,gam	Γ	*+
,gb 	⑻	*+
,gb 	㈧	*+
,gb 	⒝	*+
,gb 	㎇	*+
,gbb	㈾	*+
,gbi	㈾	*+
,gbz	㈽	*+
,gc 	⑺	*+
,gc 	㈦	*+
,gc 	⒞	*+
,gco	㈴	*+
,gd 	⒟	*+
,gdo	㈰	*+
,ge 	⑴	*+
,ge 	㈠	*+
,ge 	⒠	*+
,geb	⒅	*+
,gec	⒄	*+
,gee	⑾	*+
,gef	⒁	*+
,gek	⒆	*+
,gel	⒃	*+
,geo	⑽	*+
,ger	⑿	*+
,ges	⒀	*+
,gew	⒂	*+
,gf 	⑷	*+
,gf 	㈣	*+
,gf 	⒡	*+
,gfn	㈫	*+
,gg 	）	*+
,gg 	〕	*+
,gg 	〗	*+
,gg 	⒢	*+
,ggv	∨	*+
,gh 	⒣	*+
,ghz	㎓	*+
,gi 	丬	*+
,gi 	爿	*+
,gi 	⒤	*+
,gj 	⑽	*+
,gj 	㈩	*+
,gj 	⒥	*+
,gja	㉀	*+
,gjb	⒅	*+
,gjc	⒄	*+
,gjd	㈿	*+
,gje	⑾	*+
,gjf	⒁	*+
,gjk	⒆	*+
,gjl	⒃	*+
,gjr	⑿	*+
,gjr	㉀	*+
,gjs	⒀	*+
,gjw	⒂	*+
,gk 	⑼	*+
,gk 	㈨	*+
,gk 	⒦	*+
,gl 	⑹	*+
,gl 	㈥	*+
,gl 	⒧	*+
,gm 	⒨	*+
,gmb	㈶	*+
,gmu	㈶	*+
,gn 	⒩	*+
,gn 	㆝	*+
,gnn	㆝	*+
,go 	㈩	*+
,go 	⒪	*+
,goh	㈺	*+
,gp 	爿	*+
,gp 	⒫	*+
,gpa	㎬	*+
,gpa	㈹	*+
,gpe	㉃	*+
,gpm	㉂	*+
,gpt	㉁	*+
,gpx	㈹	*+
,gq 	⒬	*+
,gr 	⑵	*+
,gr 	㈡	*+
,gr 	⒭	*+
,grf	㈼	*+
,grj	⒇	*+
,gro	⒇	*+
,grr	㈷	*+
,grs	㈳	*+
,grs	㈷	*+
,grv	㈼	*+
,gry	㈳	*+
,gs 	⑶	*+
,gs 	㈢	*+
,gs 	⒮	*+
,gsa	㈵	*+
,gsd	㈸	*+
,gsn	㈸	*+
,gsn	㈻	*+
,gsy	㈵	*+
,gsz	㈻	*+
,gt 	⒯	*+
,gtn	㈭	*+
,gts	㈱	*+
,gu 	⒰	*+
,gue	㈪	*+
,gv 	⒱	*+
,gw 	⑸	*+
,gw 	㈤	*+
,gw 	⒲	*+
,gwn	㈬	*+
,gx 	⒳	*+
,gxu	㈲	*+
,gy 	⒴	*+
,gy 	✈	*+
,gy 	㏉	*+
,gye	㈯	*+
,gz 	⒵	*+
,h  	ㄏ	*+
,ha 	忄	*+
,ha 	♥	*+
,ha 	♡	*+
,ha 	❤	*+
,ha 	❥	*+
,ha 	❦	*+
,ha 	❧	*+
,ha 	㏊	*+
,hat	∩	*+
,hea	☰	*+
,hea	♥	*+
,hea	♡	*+
,hea	❤	*+
,hea	❥	*+
,hea	❦	*+
,hea	❧	*+
,hh 	♥	*+
,hh 	♡	*+
,hh 	❤	*+
,hh 	❥	*+
,hh 	❦	*+
,hh 	❧	*+
,hi 	忄	*+
,hj 	☚	*+
,hj 	☛	*+
,hj 	☜	*+
,hj 	☝	*+
,hj 	☞	*+
,hj 	☟	*+
,hp 	ㄏ	*+
,hp 	☮	*+
,hp 	㏋	*+
,hpa	㍱	*+
,hz 	㎐	*+
,i  	｜	*+
,i  	ㄧ	*+
,i  	│	*+
,i  	┃	*+
,i  	丨	*+
,ia 	Я	*+
,ia 	я	*+
,ie 	Е	*+
,ie 	е	*+
,iez	↦	*+
,il 	讠	*+
,in 	㏌	*+
,io 	Ё	*+
,io 	ё	*+
,iot	Ι	*+
,iot	ι	*+
,ip 	∤	*+
,ipx	∤	*+
,iu 	Ю	*+
,iu 	ю	*+
,iu 	ㄩ	*+
,ix 	＊	*+
,iz 	↓	*+
,iz 	讠	*+
,izz	↡	*+
,j  	Ⅹ	*+
,j  	＋	*+
,j  	ㄐ	*+
,j  	ㄓ	*+
,j  	✙	*+
,j  	✚	*+
,j  	✛	*+
,j  	✜	*+
,j  	✝	*+
,j  	✞	*+
,j  	✟	*+
,j  	✠	*+
,j  	☩	*+
,jb.	⒙	*+
,jc.	⒘	*+
,je 	Ⅺ	*+
,je 	±	*+
,je 	ⅺ	*+
,jeu	㋊	*+
,je.	⒒	*+
,jf.	⒕	*+
,ji 	ㄐ	*+
,jis	〄	*+
,jj 	＋	*+
,jj 	＃	*+
,jj 	✙	*+
,jj 	✚	*+
,jj 	✛	*+
,jj 	✜	*+
,jj 	✝	*+
,jj 	✞	*+
,jj 	✟	*+
,jj 	✠	*+
,jj 	☩	*+
,jk.	⒚	*+
,jl.	⒗	*+
,jnd	✙	*+
,jnd	✚	*+
,jnd	✛	*+
,jnd	✜	*+
,jnd	✝	*+
,jnd	✞	*+
,jnd	✟	*+
,jnd	✠	*+
,jnd	☩	*+
,jr 	Ⅻ	*+
,jr 	ⅻ	*+
,jru	㋋	*+
,jr.	⒓	*+
,js.	⒔	*+
,jue	㋉	*+
,jw.	⒖	*+
,jx 	扌	*+
,jz 	↬	*+
,j. 	⒑	*+
,k  	９	*+
,k  	Ⅸ	*+
,k  	ㄎ	*+
,ka 	К	*+
,ka 	к	*+
,ka 	々	*+
,ka 	㎄	*+
,kaa	々	*+
,kap	Κ	*+
,kap	κ	*+
,kb 	㎅	*+
,kca	㎉	*+
,ke 	₭	*+
,kha	Х	*+
,kha	х	*+
,khz	㎑	*+
,kin	♔	*+
,kin	♚	*+
,kip	₭	*+
,kk 	㏍	*+
,kl 	㎘	*+
,km 	㏎	*+
,kmm	㎢	*+
,kmm	㎦	*+
,kmr	㎢	*+
,kms	㎦	*+
,kni	♘	*+
,kni	♞	*+
,ko 	㏀	*+
,koh	㏀	*+
,kom	㏀	*+
,kpa	㎪	*+
,kt 	㏏	*+
,kue	㋈	*+
,kv 	㎸	*+
,kw 	㎾	*+
,k. 	⒐	*+
,k.k	㏍	*+
,l  	６	*+
,l  	Ⅵ	*+
,l  	λ	*+
,l  	∠	*+
,l  	┕	*+
,l  	ㄌ	*+
,l  	〆	*+
,lak	☱	*+
,lam	Λ	*+
,lb 	疒	*+
,lc 	℄	*+
,le 	￡	*+
,le 	亠	*+
,le 	⊥	*+
,le 	£	*+
,lir	₤	*+
,ll 	∠	*+
,lm 	㏐	*+
,ln 	㏑	*+
,log	㏒	*+
,lov	♥	*+
,lov	♡	*+
,lov	❤	*+
,lov	❥	*+
,lov	❦	*+
,lov	❧	*+
,lp 	ㄏ	*+
,lr 	≤	*+
,lr 	≥	*+
,lr 	₤	*+
,lue	㋅	*+
,lx 	㏓	*+
,lz 	↪	*+
,l. 	⒍	*+
,m  	÷	*+
,m  	♂	*+
,m  	ㄇ	*+
,ma 	㎃	*+
,mb 	㎆	*+
,mb 	㏔	*+
,mhz	㎒	*+
,mi 	彳	*+
,mic	µ	*+
,mil	₥	*+
,mil	㏕	*+
,ml 	㎖	*+
,mm 	㎜	*+
,mm 	㎡	*+
,mmm	㎟	*+
,mmm	㎣	*+
,mmm	㎥	*+
,mmr	㎟	*+
,mms	㎣	*+
,mo 	㏁	*+
,moh	㏁	*+
,mol	㏖	*+
,mom	㏁	*+
,moo	☽	*+
,moo	☾	*+
,mou	☶	*+
,mp 	彡	*+
,mp 	₥	*+
,mpa	㎫	*+
,mps	㎧	*+
,mps	㎨	*+
,mr 	㎡	*+
,ms 	㎥	*+
,ms 	㎳	*+
,mu 	Μ	*+
,mu 	μ	*+
,mu 	µ	*+
,mua	㎂	*+
,mue	㎛	*+
,mue	µ	*+
,muf	㎌	*+
,mug	㎍	*+
,mul	㎕	*+
,mum	㎛	*+
,mus	㎲	*+
,muv	㎶	*+
,muw	㎼	*+
,mv 	㎷	*+
,mv 	㎹	*+
,mw 	㎽	*+
,mw 	㎿	*+
,n  	И	*+
,n  	и	*+
,n  	＼	*+
,n  	⌒	*+
,n  	∩	*+
,n  	ㄋ	*+
,na 	々	*+
,na 	à	*+
,na 	㎁	*+
,naa	々	*+
,nai	₦	*+
,ne 	è	*+
,ne 	ê	*+
,nf 	㎋	*+
,ni 	ì	*+
,nm 	㎚	*+
,no 	№	*+
,no 	ò	*+
,noe	№	*+
,nr 	₦	*+
,ns 	㎱	*+
,nu 	Ν	*+
,nu 	ν	*+
,nu 	ù	*+
,nu 	₪	*+
,nv 	㎵	*+
,nw 	㎻	*+
,ny 	冂	*+
,ny 	勹	*+
,ny 	冖	*+
,ny 	宀	*+
,nz 	↯	*+
,n..	ǜ	*+
,o  	０	*+
,o  	●	*+
,o  	○	*+
,o  	Ω	*+
,o  	ω	*+
,o  	。	*+
,o  	°	*+
,o  	О	*+
,o  	о	*+
,o  	ㄛ	*+
,o  	〇	*+
,oa 	＠	*+
,oa 	Ⓐ	*+
,oa 	ⓐ	*+
,oae	㊎	*+
,oa.	㋐	*+
,ob 	⑧	*+
,ob 	㊇	*+
,ob 	❽	*+
,ob 	➇	*+
,ob 	➑	*+
,ob 	Ⓑ	*+
,ob 	ⓑ	*+
,ob 	∵	*+
,obb	☯	*+
,obb	㊮	*+
,obi	㊮	*+
,obn	☹	*+
,obu	☺	*+
,obu	☻	*+
,obz	㊭	*+
,oc 	⑦	*+
,oc 	㊆	*+
,oc 	❼	*+
,oc 	➆	*+
,oc 	➐	*+
,oc 	℃	*+
,oc 	Ⓒ	*+
,oc 	ⓒ	*+
,oc 	©	*+
,oci	ↂ	*+
,oci	㊥	*+
,ocj	ↂ	*+
,ocj	㊥	*+
,oco	㊔	*+
,od 	Ⓓ	*+
,od 	ⓓ	*+
,odo	㊐	*+
,odu	☯	*+
,oe 	①	*+
,oe 	㊀	*+
,oe 	❶	*+
,oe 	➀	*+
,oe 	➊	*+
,oe 	Ⓔ	*+
,oe 	ⓔ	*+
,oe 	∵	*+
,oeb	⑱	*+
,oec	⑰	*+
,oee	⑪	*+
,oef	⑭	*+
,oek	⑲	*+
,oek	㉿	*+
,oel	⑯	*+
,oeo	⑩	*+
,oeo	㊉	*+
,oeo	❿	*+
,oeo	➉	*+
,oeo	➓	*+
,oep	㊞	*+
,oer	⑫	*+
,oes	⑬	*+
,oew	⑮	*+
,oez	㊣	*+
,oe.	㋓	*+
,of 	④	*+
,of 	㊃	*+
,of 	❹	*+
,of 	➃	*+
,of 	➍	*+
,of 	∝	*+
,of 	Ⓕ	*+
,of 	ⓕ	*+
,ofa	㊦	*+
,ofd	㊩	*+
,ofe	㊤	*+
,ofn	㊋	*+
,ofv	㊩	*+
,og 	Ⓖ	*+
,og 	ⓖ	*+
,ogx	㊛	*+
,oh 	Ⓗ	*+
,oh 	ⓗ	*+
,oha	㋩	*+
,ohe	㋬	*+
,ohh	㊙	*+
,ohi	㋪	*+
,oho	㋭	*+
,ohp	㊙	*+
,ohu	㋫	*+
,oi 	Ⓘ	*+
,oi 	ⓘ	*+
,oi 	ↀ	*+
,oib	㊠	*+
,oio	ↂ	*+
,oit	㊠	*+
,oi.	㋑	*+
,oj 	⑩	*+
,oj 	㊉	*+
,oj 	❿	*+
,oj 	➉	*+
,oj 	➓	*+
,oj 	♀	*+
,oj 	Ⓙ	*+
,oj 	ⓙ	*+
,ojb	⑱	*+
,ojc	⑰	*+
,ojd	㊯	*+
,oje	⑪	*+
,ojf	⑭	*+
,oji	〄	*+
,ojk	⑲	*+
,ojl	⑯	*+
,ojr	⑫	*+
,ojs	⑬	*+
,ojw	⑮	*+
,ok 	⑨	*+
,ok 	㊈	*+
,ok 	❾	*+
,ok 	➈	*+
,ok 	➒	*+
,ok 	Ⓚ	*+
,ok 	ⓚ	*+
,ok 	㉿	*+
,oka	㋕	*+
,oke	㉿	*+
,oke	㋘	*+
,oki	㋖	*+
,oko	㋙	*+
,oku	㋗	*+
,ol 	⑥	*+
,ol 	㊅	*+
,ol 	❻	*+
,ol 	➅	*+
,ol 	➏	*+
,ol 	Ⓛ	*+
,ol 	ⓛ	*+
,oln	㊜	*+
,olp	㊰	*+
,olu	㊰	*+
,olw	㊜	*+
,olx	㊰	*+
,om 	Ⓜ	*+
,om 	ⓜ	*+
,oma	㋮	*+
,omb	㊖	*+
,ome	㋱	*+
,omi	Ο	*+
,omi	ο	*+
,omi	㋯	*+
,omo	㋲	*+
,omu	㊖	*+
,omu	㋰	*+
,on 	Ⓝ	*+
,on 	ⓝ	*+
,ona	㋤	*+
,one	㊢	*+
,one	㋧	*+
,oni	㋥	*+
,onk	㊢	*+
,ono	㋨	*+
,onr	㊪	*+
,ons	㊪	*+
,onu	㋦	*+
,oo 	⓪	*+
,oo 	□	*+
,oo 	∞	*+
,oo 	◎	*+
,oo 	Ⓞ	*+
,oo 	ⓞ	*+
,ooa	☹	*+
,ood	☹	*+
,ooi	ↂ	*+
,oo.	㋔	*+
,op 	Ⓟ	*+
,op 	ⓟ	*+
,op 	∅	*+
,opo	％	*+
,opo	‰	*+
,opp	㊝	*+
,opt	㊝	*+
,opt	㊡	*+
,oq 	Ⓠ	*+
,oqd	㊚	*+
,or 	②	*+
,or 	㊁	*+
,or 	❷	*+
,or 	➁	*+
,or 	➋	*+
,or 	Ⓡ	*+
,or 	ⓡ	*+
,or 	®	*+
,ora	㋶	*+
,ore	㋹	*+
,orf	㊬	*+
,ori	〶	*+
,ori	㋷	*+
,orj	⑳	*+
,oro	⑳	*+
,oro	㋺	*+
,orr	㊗	*+
,ors	㊓	*+
,ors	㊗	*+
,oru	㋸	*+
,orv	㊬	*+
,ory	㊓	*+
,os 	③	*+
,os 	㊂	*+
,os 	❸	*+
,os 	➂	*+
,os 	➌	*+
,os 	Ⓢ	*+
,os 	ⓢ	*+
,os 	☮	*+
,os 	☄	*+
,osa	☯	*+
,osa	㊕	*+
,osa	㋚	*+
,osb	☯	*+
,osd	㊘	*+
,ose	㋝	*+
,osi	㋛	*+
,osn	㊘	*+
,osn	㊫	*+
,oso	㋞	*+
,osu	㋜	*+
,osy	㊕	*+
,osz	㊫	*+
,os.	☯	*+
,ot 	Ⓣ	*+
,ot 	ⓣ	*+
,ota	㋟	*+
,ote	㋢	*+
,oti	㋠	*+
,otn	㊍	*+
,oto	㋣	*+
,ots	㊑	*+
,otu	㋡	*+
,ou 	ㄡ	*+
,ou 	Ⓤ	*+
,ou 	ⓤ	*+
,ou 	☹	*+
,oue	㊊	*+
,ou.	㋒	*+
,ov 	Ⓥ	*+
,ov 	ⓥ	*+
,ov 	㍵	*+
,ow 	⑤	*+
,ow 	㊄	*+
,ow 	❺	*+
,ow 	➄	*+
,ow 	➎	*+
,ow 	Ⓦ	*+
,ow 	ⓦ	*+
,owa	㊟	*+
,owa	㋻	*+
,owe	㋽	*+
,owi	㋼	*+
,owk	㊟	*+
,own	㊌	*+
,owo	㋾	*+
,ox 	Ⓧ	*+
,ox 	ⓧ	*+
,oxi	㊧	*+
,oxo	㊨	*+
,oxu	㊒	*+
,oxw	㊜	*+
,oy 	Ⓨ	*+
,oy 	ⓨ	*+
,oya	㋳	*+
,oye	㊏	*+
,oyo	㋵	*+
,oyu	㋴	*+
,oyv	㊏	*+
,oyy	☯	*+
,oz 	Ⓩ	*+
,oz 	ⓩ	*+
,o. 	⊙	*+
,p  	丿	*+
,p  	／	*+
,p  	＇	*+
,p  	ㄆ	*+
,p  	ㄗ	*+
,pa 	á	*+
,pa 	㎀	*+
,pa 	㎩	*+
,pa 	㍻	*+
,paa	㎀	*+
,paw	♙	*+
,paw	♟	*+
,pc 	㍶	*+
,pe 	П	*+
,pe 	п	*+
,pe 	é	*+
,pe 	₧	*+
,pea	☮	*+
,pes	₧	*+
,pf 	㎊	*+
,pf 	☝	*+
,pf 	☟	*+
,ph 	㏗	*+
,phi	Φ	*+
,phi	φ	*+
,pi 	π	*+
,pi 	亻	*+
,pi 	卩	*+
,pi 	ㄗ	*+
,pi 	Π	*+
,pi 	í	*+
,pm 	㏘	*+
,pn 	ń	*+
,po 	ó	*+
,pos	〒	*+
,pos	〶	*+
,pos	〠	*+
,pou	£	*+
,pp 	〃	*+
,pp 	∥	*+
,pp 	″	*+
,ppm	㏙	*+
,pr 	㏚	*+
,pro	∏	*+
,ps 	㎰	*+
,psi	Ψ	*+
,psi	ψ	*+
,pts	₧	*+
,pu 	ú	*+
,pv 	㎴	*+
,pw 	㎺	*+
,px 	夂	*+
,px 	攵	*+
,px 	☚	*+
,px 	☛	*+
,px 	☜	*+
,px 	☞	*+
,py 	✉	*+
,p.m	㏘	*+
,p..	ǘ	*+
,q  	θ	*+
,q  	ㄑ	*+
,qi 	㆙	*+
,qp 	犭	*+
,qt 	♠	*+
,que	♕	*+
,que	♛	*+
,qx 	犭	*+
,qx 	≠	*+
,r  	２	*+
,r  	Ⅱ	*+
,r  	＝	*+
,r  	ㄖ	*+
,r  	ㄦ	*+
,r  	㆓	*+
,rad	㎭	*+
,rad	㎮	*+
,rad	㎯	*+
,rat	∶	*+
,re 	〓	*+
,re 	Э	*+
,re 	＝	*+
,ree	☱	*+
,rer	☵	*+
,res	₨	*+
,rho	Ρ	*+
,rho	ρ	*+
,ri 	刂	*+
,ri 	‖	*+
,ri 	〒	*+
,rii	〒	*+
,riv	〠	*+
,rj 	艹	*+
,rj.	⒛	*+
,roo	♖	*+
,roo	♜	*+
,ro.	⒛	*+
,rp 	≠	*+
,rp 	〃	*+
,rp 	″	*+
,rps	⅔	*+
,rpw	⅖	*+
,rpx	≠	*+
,rre	☳	*+
,rrr	☷	*+
,rs 	礻	*+
,rs 	≈	*+
,rs 	₨	*+
,ru 	殳	*+
,rue	㋁	*+
,rup	₨	*+
,r. 	⒉	*+
,s  	３	*+
,s  	Ⅲ	*+
,s  	～	*+
,s  	＆	*+
,s  	∫	*+
,s  	∽	*+
,s  	ㄙ	*+
,s  	㆔	*+
,s  	∼	*+
,sa 	纟	*+
,sa 	巛	*+
,sci	✁	*+
,sci	✂	*+
,sci	✃	*+
,sci	✄	*+
,se 	纟	*+
,se 	≡	*+
,set	∅	*+
,sh 	ㄕ	*+
,sh 	♥	*+
,sh 	♡	*+
,sh 	❤	*+
,sh 	❥	*+
,sh 	❦	*+
,sh 	❧	*+
,sha	Ш	*+
,sha	ш	*+
,shc	щ	*+
,she	Щ	*+
,she	₪	*+
,shi	ㄒ	*+
,shi	ㄕ	*+
,si 	＄	*+
,si 	巛	*+
,si 	≮	*+
,si 	$	*+
,sig	Σ	*+
,sig	σ	*+
,sig	Ъ	*+
,sig	ъ	*+
,sii	Й	*+
,sii	й	*+
,sn 	△	*+
,sn 	▲	*+
,sn 	∆	*+
,so 	∮	*+
,spa	♠	*+
,spa	♤	*+
,spb	⅜	*+
,spf	¾	*+
,spr	♨	*+
,spw	⅗	*+
,sr 	≌	*+
,sr 	♣	*+
,sr 	♧	*+
,sr 	㏛	*+
,sr 	≅	*+
,ss 	§	*+
,ss 	∥	*+
,ss 	≈	*+
,ssi	Ь	*+
,ssi	ь	*+
,st 	♤	*+
,sta	★	*+
,sta	☆	*+
,sta	✩	*+
,sta	✪	*+
,sta	✫	*+
,sta	✬	*+
,sta	✭	*+
,sta	✮	*+
,sta	✯	*+
,sta	✰	*+
,sta	✡	*+
,sue	㋂	*+
,sum	∑	*+
,sun	☼	*+
,sun	☉	*+
,sun	☀	*+
,sv 	㏜	*+
,sz 	↝	*+
,s. 	⒊	*+
,t  	ㄊ	*+
,taa	㍿	*+
,tar	㍿	*+
,tau	Τ	*+
,te 	Т	*+
,te 	т	*+
,tel	☎	*+
,tel	☏	*+
,tel	✆	*+
,tel	℡	*+
,th 	θ	*+
,the	Θ	*+
,thu	☳	*+
,thz	㎔	*+
,ti 	㆜	*+
,tm 	₮	*+
,tpp	₮	*+
,tr 	♣	*+
,tr 	♧	*+
,ts 	ㄘ	*+
,tse	Ц	*+
,tse	ц	*+
,tug	₮	*+
,ty 	✈	*+
,tz 	ㄗ	*+
,tz 	↧	*+
,u  	∪	*+
,u  	У	*+
,u  	у	*+
,u  	ㄨ	*+
,u  	µ	*+
,ua 	厶	*+
,ua 	㎂	*+
,uab	☹	*+
,uab	☺	*+
,uab	☻	*+
,uao	☹	*+
,uao	☺	*+
,uao	☻	*+
,ue 	☽	*+
,ue 	☾	*+
,uf 	㎌	*+
,ug 	㎍	*+
,ui 	ㄩ	*+
,ui 	凵	*+
,ui 	☎	*+
,ui 	☏	*+
,ui 	✆	*+
,ul 	㎕	*+
,ul 	☽	*+
,ul 	☾	*+
,um 	㎛	*+
,und	✡	*+
,ups	Υ	*+
,ups	υ	*+
,uq 	豸	*+
,us 	㎲	*+
,uv 	㎶	*+
,uw 	㎼	*+
,uz 	↯	*+
,v  	”	*+
,v  	」	*+
,v  	ˇ	*+
,v  	∠	*+
,v  	√	*+
,v  	✓	*+
,v  	✔	*+
,v  	∧	*+
,v  	∨	*+
,va 	衤	*+
,va 	ǎ	*+
,vbd	∞	*+
,ve 	√	*+
,ve 	В	*+
,ve 	в	*+
,ve 	ě	*+
,ve 	≤	*+
,vi 	≮	*+
,vi 	≯	*+
,vi 	ǐ	*+
,vn 	ň	*+
,vo 	ǒ	*+
,vp 	髟	*+
,vr 	≤	*+
,vr 	≥	*+
,vu 	ǔ	*+
,vv 	丶	*+
,v..	ǚ	*+
,w  	５	*+
,w  	Ⅴ	*+
,w  	ω	*+
,w  	♀	*+
,w  	ㄨ	*+
,wa 	幺	*+
,wat	☵	*+
,wb 	㏝	*+
,wd 	☄	*+
,we 	氵	*+
,we 	￦	*+
,win	☴	*+
,wn 	廴	*+
,wn 	辶	*+
,wo 	♀	*+
,won	₩	*+
,won	￦	*+
,wp 	♨	*+
,wpb	⅝	*+
,wpl	⅚	*+
,wr 	₩	*+
,wu 	ㄨ	*+
,wue	㋄	*+
,w. 	⒌	*+
,x  	Ⅹ	*+
,x  	×	*+
,x  	ㄒ	*+
,x  	〆	*+
,x  	✕	*+
,x  	✖	*+
,x  	✗	*+
,x  	✘	*+
,xf 	※	*+
,xi 	Ξ	*+
,xi 	＊	*+
,xi 	☚	*+
,xi 	☜	*+
,xl 	饣	*+
,xo 	☛	*+
,xo 	☞	*+
,xs 	✝	*+
,xs 	✞	*+
,xs 	✟	*+
,xx 	×	*+
,xx 	✕	*+
,xx 	✖	*+
,xx 	✗	*+
,xx 	✘	*+
,xx 	∃	*+
,xx 	∤	*+
,xz 	↛	*+
,y  	ㄧ	*+
,ya 	㆞	*+
,yal	㆞	*+
,ye 	±	*+
,yen	¥	*+
,yer	Ы	*+
,yer	ы	*+
,yin	☯	*+
,yr 	￥	*+
,yr 	¥	*+
,ys 	✝	*+
,ys 	✞	*+
,ys 	✟	*+
,yu 	ㄩ	*+
,yy 	☯	*+
,z  	↓	*+
,z  	↑	*+
,z  	←	*+
,z  	→	*+
,ze 	←	*+
,ze 	З	*+
,ze 	з	*+
,zed	☺	*+
,zed	☻	*+
,zei	↤	*+
,zet	Ζ	*+
,zet	ζ	*+
,zez	↔	*+
,zez	↢	*+
,zez	↣	*+
,zgn	☺	*+
,zgn	☻	*+
,zh 	ㄓ	*+
,zhe	Ж	*+
,zhe	ж	*+
,zhi	ㄓ	*+
,zi 	↑	*+
,zie	↥	*+
,ziz	↨	*+
,zj 	↫	*+
,zl 	虍	*+
,zl 	㆚	*+
,zl 	↥	*+
,zl 	↩	*+
,zo 	♂	*+
,zs 	↜	*+
,zsz	↭	*+
,zt 	✈	*+
,zty	✈	*+
,zu 	☺	*+
,zu 	☻	*+
,zwz	↭	*+
,zx 	↚	*+
,zxz	↮	*+
,zz 	㆚	*+
,zz 	↯	*+
,zze	↞	*+
,zzi	↟	*+
,,  	“	*+
,,  	”	*+
,,  	「	*+
,,  	〈	*+
,,  	＜	*+
,,  	《	*+
,,  	，	*+
,,v 	”	*+
,,v 	」	*+
,,, 	《	*+
,,, 	«	*+
,.  	·	*+
,.  	．	*+
,.  	〉	*+
,.  	＞	*+
,.r.	≑	*+
,.. 	∶	*+
,.. 	》	*+
,.. 	»	*+
,..e	Ё	*+
,..e	ё	*+
,..u	ü	*+
,...	┆	*+
,...	┇	*+
,...	┊	*+
,...	┋	*+
,...	∵	*+
,...	∴	*+
,...	┄	*+
,...	┅	*+
,...	┈	*+
,...	┉	*+
,'  	‘	*+
,'  	’	*+
,'  	′	*+
,'  	＂	*+
,'  	＇	*+
,'  	，	*+
,'' 	’	*+
,[  	「	*+
,[  	｛	*+
,[  	［	*+
,[  	【	*+
,[  	〈	*+
,[  	（	*+
,[  	＜	*+
,[  	〔	*+
,[  	〖	*+
,[v 	∧	*+
,[[ 	《	*+
,[[ 	【	*+
,[[ 	『	*+
,[[ 	«	*+
,]  	」	*+
,]  	｝	*+
,]  	］	*+
,]  	】	*+
,]  	〉	*+
,]  	）	*+
,]  	＞	*+
,]  	〕	*+
,]  	〗	*+
,]v 	∨	*+
,]] 	》	*+
,]] 	】	*+
,]] 	』	*+
,]] 	»	*+
.   	。	*+
.oq 	ⓠ	*+
.,  	；	*+
..  	：	*+
..  	¨	*+
..  	＋	*+
..  	━	*+
..  	×	*+
..  	÷	*+
..  	＝	*+
..  	∶	*+
..  	》	*+
... 	…	*+
... 	∵	*+
... 	∴	*+
'   	、	*+
'   	．	*+
'   	·	*+
'   	＂	*+
'   	＇	*+
''  	“	*+
''' 	”	*+
''' 	＂	*+
[   	「	*+
[   	〈	*+
[   	【	*+
[v  	（	*+
[v  	∧	*+
[[  	《	*+
[[  	【	*+
[[  	『	*+
[[  	«	*+
]   	」	*+
]   	〉	*+
]   	】	*+
]v  	）	*+
]v  	∨	*+
]]  	》	*+
]]  	】	*+
]]  	』	*+
]]  	»	*+
